abbatial|abbatiale
abdominal|abdominale
aberrant|aberrante
abject|abjecte
abominable|abominable
abondant|abondante
abordable|abordable
aborigène|aborigène
abortif|abortive
aboulique|aboulique
abracadabrant|abracadabrante
abrasif|abrasive
abricot|abricot
abrogeable|abrogeable
abrupt|abrupte
abscons|absconse
absent|absente
absolu|absolue
abstinent|abstinente
abstrait|abstraite
abstrus|abstruse
absurde|absurde
abusif|abusive
abyssal|abyssale
académique|académique
acajou|acajou
acariâtre|acariâtre
accablant|accablante
acceptable|acceptable
accessible|accessible
accidentel|accidentelle
accort|accorte
accueillant|accueillante
accusateur|accusatrice
acerbe|acerbe
achalandé|achalandée
acide|acide
acidulé|acidulée
acoustique|acoustique
acrimonieux|acrimonieuse
acrobatique|acrobatique
acrylique|acrylique
actif|active
activiste|activiste
actuariel|actuarielle
actuel|actuelle
acéré|acérée
additif|additives
additionnel|additionnelle
adhérent|adhérente
adhésif|adhésive
adipeux|adipeuse
adjacent|adjacente
adjectif|adjective
adjectival|adjectivale
adjoint|adjointe
adjudicataire|adjudicataire
adjudicateur|adjudicatrice
administratif|administrative
administratif|administratives
admirable|admirable
admiratif|admirative
admissible|admissible
adoptable|adoptable
adoptif|adoptive
adoptif|adoptives
adorable|adorable
adoucissant|adoucissante
adroit|adroite
adulte|adulte
adultère|adultère
adultérin|adultérine
adventice|adventice
adverbial|adverbiale
adverse|adverse
adéquat|adéquate
affable|affable
affairiste|affairiste
affectif|affective
affectueux|affectueuse
affidé|affidée
affirmatif|affirmative
affixal|affixale
affligeant|affligeante
affreux|affreuse
afférent|afférente
afghan|afghane
afocal|afocale
africain|africaine
afrikaans|afrikaans
agaçant|agaçante
aggravant|aggravante
agile|agile
agissant|agissante
agnostique|agnostique
agraire|agraire
agrammatical|agrammaticale
agrarien|agrarienne
agressif|agressive
agreste|agreste
agricole|agricole
agroalimentaire|agroalimentaire
agronomique|agronomique
agréable|agréable
agrémenté|agrémentée
ahurissant|ahurissante
aigre|aigre
aigrelet|aigrelette
aigu|aiguë
ailé|ailée
aimable|aimable
aisé|aisée
ajouré|ajourée
alambiqué|alambiquée
alarmant|alarmante
alarmiste|alarmiste
albanais|albanaise
albinos|albinos
alcalin|alcalin
alcoolique|alcoolique
alcoométrique|alcoométrique
alerte|alerte
alezan|alezane
algébrique|algébrique
algérien|algérienne
alimentaire|alimentaire
allaitant|allaitante
allemand|allemande
allergique|allergique
alliacé|alliacée
allié|alliée
allogène|allogène
allumeur|allumeuse
allusif|allusive
alluvial|alluviale
allègre|allègre
allégorique|allégorique
almeydiste|almeydiste
alpestre|alpestre
alphabétique|alphabétique
alpin|alpine
alsacien|alsacienne
alternatif|alternative
altier|altière
aléatoire|aléatoire
alémanique|alémanique
amarante|amarante
amaril|amarile
amateur|amateur
amateur|amatrice
amazonien|amazonienne
ambiant|ambiante
ambidextre|ambidextre
ambigu|ambiguë
ambitieux|ambitieuse
ambivalent|ambivalente
amblyope|amblyope
ambulant|ambulante
ambulatoire|ambulatoire
amensal|amensale
amer|amère
ami|amie
amiable|amiable
amical|amicale
ammoniacal|ammoniacale
amnésique|amnésique
amoral|amorale
amorphe|amorphe
amoureux|amoureuse
amovible|amovible
amphibie|amphibie
ample|ample
amusant|amusante
amène|amène
américain|américaine
américanisé|américanisée
anachronique|anachronique
anal|anale
analgésique|analgésique
analogue|analogue
analphabète|analphabète
analytique|analytique
anarchique|anarchique
anarchiste|anarchiste
anatomique|anatomique
ancestral|ancestrale
ancien|ancienne
andalou|andalouse
andin|andine
andéen|andéen
anecdotique|anecdotique
anglais|anglaise
anglican|anglicane
anglophile|anglophile
anglophone|anglophone
angoissant|angoissante
angolais|angolaise
angora|angora
angulaire|angulaire
anguleux|anguleuse
angélique|angélique
animal|animale
animalier|animalière
animiste|animiste
annamite|annamite
annexe|annexe
annonciateur|annonciatrice
annuel|annuelle
anodin|anodine
anomal|anomale
anonyme|anonyme
anormal|anormale
antagoniste|antagoniste
antarctique|antarctique
anthracite|anthracite
anthropique|anthropique
anthropocentrique|anthropocentrique
anthropologique|anthropologique
anthropomorphe|anthropomorphe
anthropoïde|anthropoïde
antiapartheid|antiapartheid
antiaérien|antiaérienne
antibiotique|antibiotique
antibrouillard|antibrouillard
antibruit|antibruit
anticasseurs|anticasseurs
antichar|antichar
anticlinal|anticlinale
anticlérical|anticléricale
anticoccidien|anticoccidienne
anticommuniste|anticommuniste
anticoncurrentiel|anticoncurrentielle
anticonstitutionnel|anticonstitutionnelle
anticyclonal|anticyclonale
antidémocratique|antidémocratique
antifasciste|antifasciste
antigang|antigang
antigel|antigel
antiglisse|antiglisse
antigouvernemental|antigouvernementale
antillais|antillaise
antimarxiste|antimarxiste
antinational|antinationale
antinationaliste|antinationaliste
antinomique|antinomique
antinucléaire|antinucléaire
antiparasitaire|antiparasitaire
antiparti|antiparti
antipersonnel|antipersonnelle
antipoison|antipoison
antipollution|antipollution
antique|antique
antirabique|antirabique
antiraciste|antiraciste
antirocardien|antirocardienne
antirouille|antirouille
antisandiniste|antisandiniste
antisocial|antisociale
antisocialiste|antisocialiste
antisyndical|antisyndicale
antisémite|antisémite
antiterroriste|antiterroriste
antithétique|antithétique
antitrust|antitrust
antécédent|antécédente
antédiluvien|antédiluvienne
antépénultième|antépénultième
antérieur|antérieure
anversois|anversoise
anxieux|anxieuse
aouniste|aouniste
apaisant|apaisante
apeuré|apeurée
aphone|aphone
aphrodisiaque|aphrodisiaque
aphteux|aphteuse
apical|apicale
apicole|apicole
apocalyptique|apocalyptique
apocryphe|apocryphe
apolitique|apolitique
apoplectique|apoplectique
apostat|apostate
apostolique|apostolique
apparent|apparente
appauvrissant|appauvrissante
appellatif|appellative
applicable|applicable
approbateur|approbatrice
approximatif|approximative
appréciable|appréciable
appétissant|appétissante
apte|apte
aquacole|aquacole
aquatique|aquatique
aqueux|aqueuse
aquifère|aquifère
arabe|arabe
arable|arable
arabophone|arabophone
arachnéen|arachnéenne
aragonais|aragonaise
aratoire|aratoire
arbitraire|arbitraire
arbitral|arbitrale
arborescent|arborescente
arboricole|arboricole
archaïque|archaïque
architectonique|architectonique
architectural|architecturale
archéologique|archéologique
arctique|arctique
ardent|ardente
ardu|ardue
ardéchois|ardéchoise
argentin|argentine
argileux|argileuse
argumentaire|argumentaire
aride|aride
aristocrate|aristocrate
aristocratique|aristocratique
arlésien|arlésienne
armorial|armoriale
arménien|arménienne
aromatique|aromatique
arriviste|arriviste
arrière|arrière
arriéré|arriérée
arrogant|arrogante
artificiel|artificielle
artisanal|artisanale
artistique|artistique
artériel|artérielle
aryen|aryenne
ascendant|ascendante
ascensionnel|ascensionnelle
ascétique|ascétique
asexué|asexuée
asiatique|asiatique
asocial|asociale
asphyxiant|asphyxiante
aspirateur|aspiratrice
assaillant|assaillante
assidu|assidue
assimilable|assimilable
assis|assise
associatif|associative
assonant|assonante
astigmate|astigmate
astral|astrale
astringent|astringente
astrologique|astrologique
astronomique|astronomique
astrononique|astrononique
astrophysique|astrophysique
astucieux|astucieuse
asturien|asturienne
athlétique|athlétique
athée|athée
athénien|athénienne
atlantique|atlantique
atlantiste|atlantiste
atmosphérique|atmosphérique
atomique|atomique
atonal|atonale
atone|atone
atroce|atroce
attachant|attachante
attenant|attenante
attentatoire|attentatoire
attentif|attentive
attentionné|attentionnée
attractif|attractive
attrayant|attrayante
attribuable|attribuable
atténuant|atténuante
atypique|atypique
auburn|auburn
aubère|aubère
audacieux|audacieuse
audible|audible
audiovisuel|audiovisuelle
auditif|auditives
augural|augurale
auguste|auguste
aurifère|aurifère
auroral|aurorale
auréolé|auréolée
austral|australe
australien|australienne
austère|austère
authentique|authentique
autobiographique|autobiographique
autocollant|autocollante
autodidacte|autodidacte
autogestionnaire|autogestionnaire
automatique|automatique
automatisable|automatisable
automatisé|automatisée
automnal|automnale
automobile|automobile
automobiliste|automobiliste
automoteur|automotrice
autonome|autonome
autonomiste|autonomiste
autoritaire|autoritaire
autoroutier|autoroutière
autosuffisant|autosuffisante
autre|autre
autre|autre
autrichien|autrichienne
auxerrois|auxerroise
auxiliaire|auxiliaire
avantageux|avantageuse
avare|avare
avenant|avenante
aventureux|aventureuse
aventurier|aventurière
avenu|avenue
aveuglant|aveuglante
aveugle|aveugle
aviaire|aviaire
avicole|avicole
avide|avide
aviné|avinée
avoisinant|avoisinante
avoriazien|avoriazienne
avouable|avouable
axial|axiale
azeri|azerie
azimutal|azimutale
azoté|azotée
azyme|azyme
azéri|azérie
aérien|aérienne
aérobie|aérobie
aérodynamique|aérodynamique
aéronautique|aéronautique
aéronaval|aéronavale
aéroportuaire|aéroportuaire
aéroporté|aéroportée
aéropostal|aéropostale
aérospatial|aérospatiale
aérostatique|aérostatique
aéré|aérée
aîné|aînée
baba|baba
babylonien|babylonienne
bactéricide|bactéricide
bactérien|bactérienne
bactériologique|bactériologique
badaud|badaude
badin|badine
bagarreur|bagarreuse
bagué|baguée
bai|baie
balbutiant|balbutiante
baleinier|baleinière
balkanique|balkanique
ballant|ballante
ballottant|ballottante
balnéaire|balnéaire
balourd|balourde
balte|balte
banal|banale
bancaire|bancaire
bancal|bancale
banlieusard|banlieusarde
bantou|bantoue
baoulé|baoulé
baptismal|baptismale
barbare|barbare
barbelé|barbelée
barbet|barbette
barbu|barbue
barlong|barlongue
baroque|baroque
barriste|barriste
bas|basse
basal|basale
basilical|basilicale
basque|basque
bataillonnaire|bataillonnaire
bathyal|bathyale
battant|battante
bavard|bavarde
bavarois|bavaroise
baveux|baveuse
bayadère|bayadère
beau|belle
beige|beige
belge|belge
belligérant|belligérante
belliqueux|belliqueuse
benoît|benoîte
benthique|benthique
berbère|berbère
berlinois|berlinoise
besogneux|besogneuse
bestial|bestiale
betteravier|betteravière
beur|beur
beylical|beylicale
biais|biaise
biannuel|biannuelle
biaural|biaurale
biblique|biblique
bicolore|bicolore
bicéphale|bicéphale
bien|bien
bienfaisant|bienfaisante
bienheureux|bienheureuse
biennal|biennale
bienséant|bienséante
bienveillant|bienveillante
bienvenu|bienvenue
bifocal|bifocale
bigame|bigame
bilatéral|bilatérale
bileux|bileuse
biliaire|biliaire
bilingue|bilingue
bimensuel|bimensuelle
bimoteur|bimoteur
binaire|binaire
binational|binationale
binaural|binaurale
binomial|binomiale
bio|bio
biocide|biocide
biodégradable|biodégradable
biographique|biographique
biologique|biologique
biomédical|biomédicale
biotechnologique|biotechnologique
bioéthique|bioéthique
biparti|bipartie
bipartite|bipartite
bipolaire|bipolaire
bipède|bipède
birman|birmane
bis|bise
bisannuel|bisannuelle
biscornu|biscornue
bistre|bistre
bizarre|bizarre
blafard|blafarde
blanc|blanche
blanchâtre|blanchâtre
blasphémateur|blasphématrice
blennorragique|blennorragique
blessé|blessée
blet|blette
bleu|bleue
bleuté|bleutée
bleuâtre|bleuâtre
blindé|blindée
blond|blonde
blâmable|blâmable
blême|blême
bohème|bohème
bohémien|bohémienne
boiteux|boiteuse
bolchevik|bolchevik
bolchevique|bolchevique
bolivien|bolivienne
bon|bonne
bonasse|bonasse
bondé|bondée
bordelais|bordelaise
borgne|borgne
borgésien|borgésienne
boréal|boréale
bossu|bossue
bot|bote
botswanais|botswanaise
botté|bottée
bouddhique|bouddhique
bouddhiste|bouddhiste
boudeur|boudeuse
boueux|boueuse
bouffon|bouffonne
bouffonnant|bouffonnante
bouffonneux|bouffonneuse
bougon|bougonne
bouillant|bouillante
bouillonnant|bouillonnante
bouleversant|bouleversante
boulimique|boulimique
boulot|boulotte
bourdonnant|bourdonnante
bourgeois|bourgeoise
bourrelé|bourrelée
bourru|bourrue
boursier|boursière
boutonneux|boutonneuse
bouvillois|bouvilloise
bovin|bovine
brachial|brachiale
brahmanique|brahmanique
branchial|branchiale
braque|braque
brassicole|brassicole
brave|brave
bredouille|bredouille
bref|brève
brejnévien|brejnévienne
breton|bretonne
brevetable|brevetable
bricoleur|bricoleuse
bridé|bridée
brillant|brillante
brilliant|brilliante
britannique|britannique
bronchique|bronchique
brouillon|brouillonne
bruissant|bruissante
brumeux|brumeuse
brun|brune
brunâtre|brunâtre
brusque|brusque
brut|brute
brutal|brutale
bruxellois|bruxelloise
bruyant|bruyante
brésilien|brésilienne
brûlant|brûlante
buccal|buccale
bucolique|bucolique
budgétaire|budgétaire
buissonneux|buissonneuse
buissonnier|buissonnière
bulgare|bulgare
bureaucratique|bureaucratique
bureautique|bureautique
burlesque|burlesque
burundais|burundaise
buvable|buvable
byzantin|byzantin
byzantin|byzantine
bâtard|bâtarde
bâti|bâtie
bègue|bègue
béant|béante
béarnais|béarnaise
béat|béate
bédouin|bédouine
bée|bée
bégueule|bégueule
bénin|bénigne
bénit|bénite
bénéficiaire|bénéficiaire
bénéfique|bénéfique
bénévole|bénévole
bêta|bêtasse
bête|bête
cabochard|cabocharde
cabotin|cabotine
cachectique|cachectique
cacher|cacher
cacochyme|cacochyme
cadastral|cadastrale
cadavéreux|cadavéreuse
cadavérique|cadavérique
cadet|cadette
caduc|caduque
caecal|caecale
cafard|cafarde
cagneux|cagneuse
cagot|cagote
cahotant|cahotante
cahoteux|cahoteuse
caillouteux|caillouteuse
calcaire|calcaire
calcifié|calcifiée
californien|californienne
calleux|calleuse
callipyge|callipyge
calme|calme
calomnieux|calomnieuse
calorifique|calorifique
calorifère|calorifère
calédonien|calédonienne
camard|camarde
cambial|cambiale
cambodgien|cambodgienne
camerounais|camerounaise
campagnard|campagnarde
campanien|campanienne
camus|camuse
canadien|canadienne
canaque|canaque
canarien|canarienne
cancéreux|cancéreuse
cancérigène|cancérigène
cancérogène|cancérogène
candide|candide
canin|canine
cannibale|cannibale
cannois|cannoise
canonial|canoniale
canonique|canonique
cantabrique|cantabrique
cantonais|cantonaise
cantonal|cantonale
capable|capable
capital|capitale
capitalisable|capitalisable
capitaliste|capitaliste
capiteux|capiteuse
capitulaire|capitulaire
capon|caponne
capot|capot
capricieux|capricieuse
caprin|caprine
captieux|captieuse
captif|captive
captivant|captivante
carabiné|carabinée
caractéristique|caractéristique
carbonifère|carbonifère
carbonique|carbonique
carcinogène|carcinogène
carcinoïde|carcinoïde
carcéral|carcérale
cardiaque|cardiaque
cardinal|cardinale
caricatural|caricaturale
caritatif|caritatives
carminatif|carminative
carminé|carminée
carnassier|carnassière
carnivore|carnivore
carné|carnée
carolingien|carolingienne
carrossable|carrossable
carré|carrée
cartésien|cartésienne
casablancais|casablancaise
casanier|casanière
cascher|cascher
casqué|casquée
cassant|cassante
castillan|castillane
cataclysmal|cataclysmale
catalan|catalane
catalectique|catalectique
cataleptique|cataleptique
catalytique|catalytique
catastrophique|catastrophique
cathartique|cathartique
cathodique|cathodique
catholique|catholique
catégoriel|catégorielle
catégorique|catégorique
caténaire|caténaire
caucasien|caucasienne
cauchemardesque|cauchemardesque
caudal|caudale
causal|causale
caustique|caustique
cauteleux|cauteleuse
cavalier|cavalière
cave|cave
caverneux|caverneuse
cellulaire|cellulaire
celtique|celtique
cendreux|cendreuse
cendré|cendrée
censorial|censoriale
censé|censée
centenaire|centenaire
centennal|centennale
centrafricain|centrafricaine
central|centrale
centralisateur|centralisatrice
centraliste|centraliste
centraméricain|centraméricaine
centriste|centriste
centroaméricain|centroaméricaine
centésimal|centésimale
certain|certaine
certain|certaine
cervical|cervicale
cessant|cessante
cessible|cessible
chafouin|chafouine
chagrin|chagrine
chaleureux|chaleureuse
champêtre|champêtre
chanceux|chanceuse
chantant|chantante
chaotique|chaotique
chapitral|chapitrale
charbonnier|charbonnière
charentais|charentaise
charismatique|charismatique
charitable|charitable
charmant|charmante
charmeur|charmeuse
charnel|charnelle
charnu|charnue
chassable|chassable
chassieux|chassieuse
chaste|chaste
chaud|chaude
chauve|chauve
chauvin|chauvine
chenu|chenue
cher|chère
chevaleresque|chevaleresque
chevelu|chevelue
chevronné|chevronnée
chic|chic
chicanier|chicanière
chiche|chiche
chiite|chiite
chilien|chilienne
chimique|chimique
chimérique|chimérique
chinois|chinoise
chirurgical|chirurgicale
chlorhydrique|chlorhydrique
chloré|chlorée
cholérique|cholérique
choquant|choquante
chorégraphique|chorégraphique
chromé|chromée
chronique|chronique
chronologique|chronologique
chrétien|chrétienne
chypriote|chypriote
châtain|châtain
chétif|chétive
cicatriciel|cicatricielle
ciliaire|ciliaire
cingalais|cingalaise
cinghalais|cinghalaise
cinglant|cinglante
cinquantenaire|cinquantenaire
cinématographique|cinématographique
cinéphile|cinéphile
cinétique|cinétique
circonflexe|circonflexe
circonspect|circonspecte
circonstanciel|circonstancielle
circonstancié|circonstanciée
circonvoisin|circonvoisin
circulaire|circulaire
circulatoire|circulatoire
circumpolaire|circumpolaire
cireux|cireuse
cisalpin|cisalpine
citadin|citadine
citrique|citrique
citron|citron
citérieur|citérieure
civil|civile
civilisé|civilisée
civique|civique
clair|claire
clairet|clairette
clairsemé|clairsemée
clairvoyant|clairvoyante
clandestin|clandestine
classique|classique
clastique|clastique
claudicant|claudicante
claustral|claustrale
clientéliste|clientéliste
climatique|climatique
climatérique|climatérique
clinique|clinique
clinquant|clinquante
cloacal|cloacale
clopinant|clopinante
clownesque|clownesque
clément|clémente
clérical|cléricale
coaxial|coaxiale
cocasse|cocasse
cochon|cochonne
cochère|cochère
codé|codée
codétenu|codétenue
coercitif|coercitive
cofinancé|cofinancée
cognitif|cognitive
cohérent|cohérente
cohésif|cohésive
coi|coite
coliforme|coliforme
collaborationniste|collaborationniste
collant|collante
collatéral|collatérale
collectif|collective
collectivisé|collectivisée
colloïdal|colloïdale
collégial|collégiale
colombien|colombienne
colonial|coloniale
colorant|colorante
colossal|colossale
coléreux|coléreuse
colérique|colérique
comateux|comateuse
combatif|combative
combattant|combattante
comble|comble
combustible|combustible
comestible|comestible
comique|comique
comitial|comitiale
commandité|commanditée
commençant|commençante
commercial|commerciale
commercialisable|commercialisable
commerçant|commerçante
comminatoire|comminatoire
commissoire|commissoire
commode|commode
commun|commune
communal|communale
communautaire|communautaire
communicable|communicable
communicant|communicante
communisant|communisante
communiste|communiste
commémoratif|commémorative
compact|compacte
comparable|comparable
comparatif|comparative
compatible|compatible
compatissant|compatissante
compensateur|compensatrice
compensatoire|compensatoire
complaisant|complaisante
complet|complète
complexe|complexe
complice|complice
compliqué|compliquée
complémentaire|complémentaire
comportemental|comportementale
composite|composite
compound|compound
compressible|compressible
compréhensible|compréhensible
compréhensif|compréhensive
compréhensif|compréhensives
comptable|comptable
compulsif|compulsive
compétent|compétente
compétitif|compétitive
compétitif|compétitives
comédien|comédienne
con|con
concave|concave
concentratif|concentratives
concentrique|concentrique
concepteur|conceptrice
conceptuel|conceptuelle
concerté|concertée
concessionnaire|concessionnaire
concevable|concevable
conchoïdal|conchoïdale
conchylicole|conchylicole
conciliable|conciliable
conciliaire|conciliaire
conciliant|conciliante
conciliateur|conciliatrice
concis|concise
concluant|concluante
concomitant|concomitante
concordant|concordante
concret|concrète
concupiscent|concupiscente
concurrent|concurrente
concurrentiel|concurrentielle
concussionnaire|concussionnaire
condamnable|condamnable
condensateur|condensatrice
conditionnel|conditionnelle
conducteur|conductrice
confessionnel|confessionnelle
confiant|confiante
confidentiel|confidentielle
conflictuel|conflictuelle
confluent|confluente
conforme|conforme
conformiste|conformiste
confortable|confortable
confucéen|confucéenne
confus|confuse
confédéral|confédérale
congolais|congolaise
congru|congrue
congréganiste|congréganiste
congénital|congénitale
congénère|congénère
conique|conique
conjectural|conjecturale
conjoint|conjointe
conjonctif|conjonctive
conjoncturel|conjoncturelle
conjoncturiste|conjoncturiste
conjugal|conjugale
connexe|connexe
conquérant|conquérante
consanguin|consanguine
consciencieux|consciencieuse
conscient|consciente
consensuel|consensuelle
consentant|consentante
conservateur|conservatrice
considérable|considérable
consignataire|consignataire
consistant|consistante
consomptible|consomptible
consonant|consonante
consonantique|consonantique
constant|constante
consternant|consternante
constituant|constituante
constitutif|constitutive
constitutionnel|constitutionnelle
constructible|constructible
constructif|constructive
consubstantiel|consubstantielle
consulaire|consulaire
consultable|consultable
consultatif|consultative
consécutif|consécutive
conséquent|conséquente
contagieux|contagieuse
contaminant|contaminante
contaminateur|contaminatrice
contemporain|contemporaine
content|contente
contentieux|contentieuse
contestable|contestable
contestataire|contestataire
contigu|contiguë
continent|continente
continental|continentale
contingent|contingente
contingentaire|contingentaire
continu|continue
continuel|continuelle
contondant|contondante
contraceptif|contraceptives
contractant|contractante
contractuel|contractuelle
contradictoire|contradictoire
contraignant|contraignante
contraire|contraire
contrastant|contrastante
contrepartiste|contrepartiste
contrevenant|contrevenante
contrit|contrite
controuvé|controuvée
controversé|controversée
contrôlable|contrôlable
contumax|contumax
convaincant|convaincante
convalescent|convalescente
convenable|convenable
conventionnel|conventionnelle
conventuel|conventuelle
convergent|convergente
convers|converse
convertible|convertible
convexe|convexe
convivial|conviviale
convulsif|convulsive
coopératif|coopératives
coordinateur|coordinatrice
coordonnateur|coordonnatrice
coparrainé|coparrainée
copieux|copieuse
coprophage|coprophage
coprésidé|coprésidée
copte|copte
coquet|coquette
corallien|corallienne
corallin|coralline
coranique|coranique
cordial|cordiale
coriace|coriace
cornélien|cornélienne
coronaire|coronaire
coronarien|coronarienne
corporatif|corporative
corporatiste|corporatiste
corporel|corporelle
corpulent|corpulente
correct|correcte
correctif|correctives
correctionnel|correctionnelle
correspondant|correspondante
corrosif|corrosive
corrélatif|corrélative
corrézien|corrézienne
corse|corse
cortical|corticale
coréen|coréenne
cosmique|cosmique
cosmopolite|cosmopolite
cossu|cossue
costal|costale
costaricain|costaricaine
costaricien|costaricienne
costaud|costaud
cotisant|cotisante
cotonneux|cotonneuse
cotonnier|cotonnière
couard|couarde
couillon|couillon
coulant|coulante
coulissant|coulissante
coupable|coupable
courageux|courageuse
courant|courante
courbatu|courbatue
courbe|courbe
court|courte
courtaud|courtaude
courtois|courtoise
coutumier|coutumière
couvert|couverte
coïncident|coïncidente
coûteux|coûteuse
craintif|craintive
cramoisi|cramoisie
crapule|crapule
crapuleux|crapuleuse
crasseux|crasseuse
crayeux|crayeuse
creusé|creusée
creux|creuse
criant|criante
criard|criarde
criminel|criminelle
cristallin|cristalline
critiquable|critiquable
critique|critique
croate|croate
crochu|crochue
croissant|croissante
croustillant|croustillante
croyable|croyable
croyant|croyante
cru|crue
crucial|cruciale
cruciforme|cruciforme
cruel|cruelle
crural|crurale
crâne|crâne
crânien|crânienne
créancier|créancière
créatif|créative
crédible|crédible
créditeur|créditrice
crédule|crédule
crématoire|crématoire
crémeux|crémeuse
créole|créole
crépu|crépue
crétacé|crétacée
crétois|crétoise
cubain|cubaine
cubique|cubique
cubital|cubitale
cuisant|cuisante
culinaire|culinaire
cultivable|cultivable
culturel|culturelle
cumulatif|cumulatives
cunéiforme|cunéiforme
cupide|cupide
curable|curable
curatif|curative
curatif|curatives
curieux|curieuse
cursif|cursive
curviligne|curviligne
cutané|cutanée
cyanhydrique|cyanhydrique
cyclable|cyclable
cyclique|cyclique
cyclopéen|cyclopéenne
cyclothymique|cyclothymique
cynique|cynique
cynégétique|cynégétique
cyprinicole|cyprinicole
cyrillique|cyrillique
cytologique|cytologique
câlin|câline
cégétiste|cégétiste
céladon|céladon
céleste|céleste
célibataire|célibataire
célèbre|célèbre
cérame|cérame
céruléen|céruléenne
céréalier|céréalière
cérébelleux|cérébelleuse
cérébral|cérébrale
cérémonieux|cérémonieuse
côtelé|côtelée
côtier|côtière
daltonien|daltonienne
dangereux|dangereuse
danois|danoise
dansant|dansante
dantesque|dantesque
danubien|danubienne
dauphinois|dauphinoise
definitif|definitives
demi|demie
dense|dense
dentaire|dentaire
dental|dentale
dentellier|dentellière
dentifrice|dentifrice
dermatologique|dermatologique
dernier|dernière
descendant|descendante
descriptif|descriptive
descriptif|descriptives
despotique|despotique
destructeur|destructrice
diabolique|diabolique
diabétique|diabétique
diacritique|diacritique
diagnostique|diagnostique
diagonal|diagonale
dialectal|dialectale
dialectique|dialectique
diamétral|diamétrale
diaphane|diaphane
dictatorial|dictatoriale
didactique|didactique
diffamatoire|diffamatoire
difficile|difficile
difforme|difforme
diffus|diffuse
différent|différente
différentiel|différentielle
digeste|digeste
digestif|digestive
digital|digitale
digne|digne
dijonnais|dijonnaise
dilatoire|dilatoire
diligent|diligente
diluvien|diluvienne
dingue|dingue
diocésain|diocésaine
dionysiaque|dionysiaque
diplomate|diplomate
diplomatique|diplomatique
diplômé|diplômée
direct|directe
directeur|directrice
directif|directive
directorial|directoriale
dirigeant|dirigeante
dirigiste|dirigiste
dirimant|dirimante
disant|disante
discal|discale
discernable|discernable
disciplinaire|disciplinaire
disco|disco
discographique|discographique
discontinu|discontinue
discordant|discordante
discourtois|discourtoise
discret|discrète
discriminatoire|discriminatoire
discrétionnaire|discrétionnaire
discursif|discursive
discutable|discutable
disert|diserte
disgracieux|disgracieuse
disparate|disparate
dispendieux|dispendieuse
dispersant|dispersante
disponible|disponible
dispos|dispose
disproportionné|disproportionnée
dissemblable|dissemblable
dissident|dissidente
dissolu|dissolue
dissonant|dissonante
dissuasif|dissuasives
dissyllabe|dissyllabe
dissyllabique|dissyllabique
distant|distante
distinct|distincte
distinctif|distinctives
distributionnel|distributionnelle
diurne|diurne
diurétique|diurétique
divergent|divergente
divers|diverse
divers|diverse
divin|divine
diététique|diététique
djiboutien|djiboutienne
docile|docile
docte|docte
doctoral|doctorale
doctrinaire|doctrinaire
doctrinal|doctrinal
doctrinal|doctrinale
dodu|dodue
dodécasyllabe|dodécasyllabe
dogmatique|dogmatique
dolent|dolente
dolichocéphale|dolichocéphale
domanial|domaniale
domestique|domestique
dominant|dominante
dominateur|dominatrice
dominical|dominicale
dommageable|dommageable
dorique|dorique
dorsal|dorsale
doré|dorée
doté|dotée
douanier|douanière
double|double
doucereux|doucereuse
douceâtre|douceâtre
douillet|douillette
douloureux|douloureuse
douteux|douteuse
doux|douce
draconien|draconienne
dramatique|dramatique
drastique|drastique
droit|droite
droitier|droitière
dru|drue
druze|druze
drôlatique|drôlatique
drôle|drôle
dual|duale
dubitatif|dubitative
ducal|ducale
ductile|ductile
duodécimal|duodécimale
duodénal|duodénale
dupe|dupe
dupé|dupée
dur|dure
durable|durable
dynamique|dynamique
dyssocial|dyssociale
déambulant|déambulante
débile|débile
débiteur|débitrice
débonnaire|débonnaire
débraillé|débraillée
débrouillard|débrouillarde
décadent|décadente
décaféiné|décaféinée
décapant|décapante
décapotable|décapotable
décasyllabe|décasyllabe
décavé|décavée
décelable|décelable
décennal|décennale
décent|décente
décevant|décevante
décharné|décharnée
déchirant|déchirante
décimal|décimale
décisif|décisive
décisionnel|décisionnelle
déclaratoire|déclaratoire
déclinant|déclinante
déclive|déclive
déconcertant|déconcertante
déconfit|déconfite
décoratif|décoratives
décousu|décousue
décroissant|décroissante
décrépit|décrépite
décuple|décuple
décuplé|décuplée
dédaigneux|dédaigneuse
déductible|déductible
défaillant|défaillante
défatigant|défatigante
défavorable|défavorable
défectif|défective
défectueux|défectueuse
défendable|défendable
défensif|défensive
défiant|défiante
déficient|déficiente
déficitaire|déficitaire
défini|définie
définitif|définitive
déflationniste|déflationniste
défunt|défunte
déférent|déférente
dégingandé|dégingandée
dégoûtant|dégoûtante
dégradable|dégradable
dégradant|dégradante
dégressif|dégressive
déguenillé|déguenillée
dégénératif|dégénératives
déicide|déicide
délassant|délassante
délectable|délectable
délibératif|délibérative
délibératif|délibératives
délibéré|délibérée
délicat|délicate
délicieux|délicieuse
délictuel|délictuelle
délictueux|délictueuse
déliquescent|déliquescente
délirant|délirante
déloyal|déloyale
déluré|délurée
délétère|délétère
démagogique|démagogique
dément|démente
démentiel|démentielle
démersal|démersale
démesuré|démesurée
démissionnaire|démissionnaire
démocrate|démocrate
démocratique|démocratique
démodé|démodée
démographique|démographique
démoniaque|démoniaque
démonstratif|démonstrative
dénonciateur|dénonciatrice
dénué|dénuée
déontologique|déontologique
départemental|départementale
dépenaillé|dépenaillée
dépendant|dépendante
dépeuplé|dépeuplée
dépité|dépitée
déplaisant|déplaisante
déplorable|déplorable
déponent|déponente
dépositaire|dépositaire
dépourvu|dépourvue
dépressif|dépressive
dépréciatif|dépréciative
déraisonnable|déraisonnable
dérangeant|dérangeante
dérisoire|dérisoire
dérivant|dérivante
dérogatoire|dérogatoire
déroutant|déroutante
désagréable|désagréable
désarmant|désarmante
désastreux|désastreuse
désavantageux|désavantageuse
désert|déserte
déserteux|déserteuse
désertique|désertique
désespérant|désespérante
déshonnête|déshonnête
désincarné|désincarnée
désinfectant|désinfectante
désintéressé|désintéressée
désinvolte|désinvolte
désirable|désirable
désireux|désireuse
désobligeant|désobligeante
désobéissant|désobéissante
désoeuvré|désoeuvrée
désolant|désolante
désopilant|désopilante
désordonné|désordonnée
déstabilisant|déstabilisante
déstabilisateur|déstabilisatrice
désuet|désuète
déséquilibrant|déséquilibrante
déséquilibré|déséquilibrée
détenteur|détentrice
détenu|détenue
déterminant|déterminante
détestable|détestable
détracteur|détractrice
dévastateur|dévastatrice
déverbal|déverbale
dévolu|dévolue
dévot|dévote
dévoué|dévouée
dû|due
ecclésiastique|ecclésiastique
eczémateux|eczémateuse
effectif|effective
effervescent|effervescente
efficace|efficace
efficient|efficiente
efflanqué|efflanquée
efflorescent|efflorescente
effrayant|effrayante
effronté|effrontée
effroyable|effroyable
effréné|effrénée
efférent|efférente
ellipsoïdal|ellipsoïdale
elliptique|elliptique
embarrassant|embarrassante
emblématique|emblématique
embroussaillé|embroussaillée
embryonnaire|embryonnaire
embu|embue
empenné|empennée
emphatique|emphatique
empirique|empirique
empoté|empotée
empreint|empreinte
emprunté|empruntée
encerclable|encerclable
enchanteur|enchanteresse
enchifrené|enchifrenée
enclin|encline
encombrant|encombrante
encourageant|encourageante
encyclopédique|encyclopédique
endiablé|endiablée
endimanché|endimanchée
endogène|endogène
endothélial|endothéliale
endurant|endurante
endémique|endémique
enfantin|enfantine
engourdissant|engourdissante
engrossé|engrossée
enivrant|enivrante
enjoué|enjouée
ennemi|ennemie
ennuyeux|ennuyeuse
enrichissant|enrichissante
enseignant|enseignante
ensilé|ensilée
ensommeillé|ensommeillée
entendant|entendante
enthousiasmant|enthousiasmante
enthousiaste|enthousiaste
entier|entière
entomologique|entomologique
entrant|entrante
entrepositaire|entrepositaire
envahissant|envahissante
enveloppant|enveloppante
enviable|enviable
envieux|envieuse
environnant|environnante
environnemental|environnementale
envisageable|envisageable
enzymatique|enzymatique
errant|errante
erratique|erratique
erroné|erronée
erse|erse
escarpé|escarpée
espacé|espacée
espagnol|espagnole
espiègle|espiègle
esquimau|esquimaude
essentiel|essentielle
esseulé|esseulée
esthétique|esthétique
estimatif|estimatives
estival|estivale
estonien|estonienne
estudiantin|estudiantine
ethnique|ethnique
ethnographique|ethnographique
ethnologique|ethnologique
euphorique|euphorique
euphorisant|euphorisante
euphémique|euphémique
eurafricain|eurafricaine
euristique|euristique
euromaghrébin|euromaghrébin
européen|européenne
exact|exacte
exagéré|exagérée
exaltant|exaltante
excellent|excellente
excentrique|excentrique
exceptionnel|exceptionnelle
excessif|excessive
excitant|excitante
exclusif|exclusive
excusable|excusable
excédentaire|excédentaire
exempt|exempte
exhaustif|exhaustive
exigeant|exigeante
exigible|exigible
exigu|exiguë
existant|existante
existentiel|existentielle
exlusif|exlusives
exogame|exogame
exorbitant|exorbitante
exotique|exotique
exotérique|exotérique
expansionniste|expansionniste
expert|experte
expiatoire|expiatoire
explicable|explicable
explicatif|explicative
explicatif|explicatives
explicite|explicite
exploitable|exploitable
explorateur|exploratrice
exploratoire|exploratoire
explosif|explosive
explétif|explétive
exponentiel|exponentielle
exportateur|exportatrice
express|express
expressif|expressive
expressionniste|expressionniste
exprès|expresse
expéditif|expéditive
expéditionnaire|expéditionnaire
expérimental|expérimentale
exquis|exquise
exsangue|exsangue
extatique|extatique
extensible|extensible
extensif|extensive
externe|externe
extra|extra
extrabudgétaire|extrabudgétaire
extracommunautaire|extracommunautaire
extracontractuel|extracontractuelle
extractif|extractive
extractif|extractives
extradable|extradable
extraditionnel|extraditionnelle
extrajudiciaire|extrajudiciaire
extralucide|extralucide
extralégal|extralégale
extraordinaire|extraordinaire
extraterrestre|extraterrestre
extraterritorial|extraterritoriale
extravagant|extravagante
extraverti|extravertie
extrinsèque|extrinsèque
extrudé|extrudée
extrémiste|extrémiste
extrême|extrême
extérieur|extérieure
exubérant|exubérante
exécrable|exécrable
exécutif|exécutive
exécutoire|exécutoire
exégétique|exégétique
fabiusien|fabiusienne
fabuleux|fabuleuse
facial|faciale
facile|facile
factice|factice
factieux|factieuse
factitif|factitive
factuel|factuelle
facultatif|facultative
facétieux|facétieuse
fade|fade
faible|faible
faignant|faignante
faillible|faillible
fainéant|fainéante
faisable|faisable
fait|faite
fallacieux|fallacieuse
falot|falote
fameux|fameuse
familial|familiale
familier|familière
famé|famée
famélique|famélique
fanatique|fanatique
fanatisé|fanatisée
fanfaron|fanfaronne
fantaisiste|fantaisiste
fantasmatique|fantasmatique
fantasque|fantasque
fantastique|fantastique
fantomatique|fantomatique
faramineux|faramineuse
faraud|faraude
farfelu|farfelue
farouche|farouche
fascinant|fascinante
fasciste|fasciste
fastidieux|fastidieuse
fastueux|fastueuse
fatal|fatale
fataliste|fataliste
fatidique|fatidique
fatigable|fatigable
fatigant|fatigante
faubourien|faubourienne
faunistique|faunistique
fautif|fautive
fauve|fauve
faux|fausse
favorable|favorable
favori|favorite
feignant|feignante
ferme|ferme
fermier|fermière
fermé|fermée
ferreux|ferreuse
ferroviaire|ferroviaire
fertile|fertile
fertilisant|fertilisante
fervent|fervente
festif|festives
feu|feue
feuillu|feuillue
feutré|feutrée
fiable|fiable
fichu|fichue
fictif|fictive
fictif|fictives
fiduciaire|fiduciaire
fidèle|fidèle
fieffé|fieffée
fielleux|fielleuse
fier|fière
filial|filiale
fin|fine
final|finale
finaliste|finaliste
financier|financière
finaud|finaude
fini|finie
finlandais|finlandaise
fiscal|fiscale
fiscaliste|fiscaliste
fissible|fissible
fissile|fissile
fixe|fixe
fiérot|fiérote
fiévreux|fiévreuse
flagrant|flagrante
flairé|flairée
flamand|flamande
flambant|flambante
flamboyant|flamboyante
flamingant|flamingante
flapi|flapie
flasque|flasque
flatteur|flatteuse
flatulent|flatulente
flavescent|flavescente
flegmatique|flegmatique
fleurdelisé|fleurdelisée
flexible|flexible
flexueux|flexueuse
floche|floche
floral|florale
florentin|florentine
florissant|florissante
floristique|floristique
flottant|flottante
flou|floue
fluent|fluente
fluet|fluette
fluide|fluide
fluidisé|fluidisée
fluo|fluo
fluorescent|fluorescente
fluorhydrique|fluorhydrique
fluvial|fluviale
fluvioglaciaire|fluvioglaciaire
focal|focale
foetal|foetale
foireux|foireuse
folichon|folichonne
folklorique|folklorique
folliculaire|folliculaire
folâtre|folâtre
foncier|foncière
fonctionnel|fonctionnelle
foncé|foncée
fondamental|fondamentale
fondamentaliste|fondamentaliste
fondant|fondante
forain|foraine
forcené|forcenée
forclos|forclose
forestier|forestière
forfaitaire|forfaitaire
formaliste|formaliste
formatif|formative
formel|formelle
formidable|formidable
formulaire|formulaire
fort|forte
fortuit|fortuite
fortuné|fortunée
fou|folle
foudroyant|foudroyante
fougueux|fougueuse
fourbe|fourbe
fourbu|fourbue
fourmillant|fourmillante
foutral|foutrale
fracassant|fracassante
fractal|fractale
fragile|fragile
fragmentaire|fragmentaire
frais|fraîche
franc|franche
franc|franque
franchissable|franchissable
franchisé|franchisée
francilien|francilienne
francophile|francophile
francophone|francophone
franquiste|franquiste
français|française
frappant|frappante
fraternel|fraternelle
fratricide|fratricide
frauduleux|frauduleuse
freudien|freudienne
friable|friable
friand|friande
frigide|frigide
frigorifique|frigorifique
frileux|frileuse
fringant|fringante
fripon|friponne
fripouillard|fripouillarde
frison|frisonne
frisquet|frisquette
frissonnant|frissonnante
frit|frite
frivole|frivole
froid|froide
frondeur|frondeuse
frontal|frontale
frontalier|frontalière
fructueux|fructueuse
frugal|frugale
frugivore|frugivore
fruitier|fruitière
fruste|fruste
frémissant|frémissante
frénétique|frénétique
fréquent|fréquente
frêle|frêle
fuchsia|fuchsia
fugace|fugace
fugitif|fugitive
fulgurant|fulgurante
fuligineux|fuligineuse
fumable|fumable
fumant|fumante
fumiste|fumiste
funeste|funeste
funèbre|funèbre
funéraire|funéraire
furibond|furibonde
furieux|furieuse
furtif|furtive
fusible|fusible
futile|futile
futur|future
futuriste|futuriste
futé|futée
fuyant|fuyante
fâcheux|fâcheuse
féal|féale
fébrile|fébrile
fécal|fécale
fécond|féconde
fédéral|fédérale
fédéraliste|fédéraliste
fédérateur|fédératrice
fédératif|fédérative
fédératif|fédératives
féerique|féerique
félin|féline
félon|félonne
féminin|féminine
féministe|féministe
fémoral|fémorale
féodal|féodale
férié|fériée
féroce|féroce
féru|férue
fétide|fétide
fêtard|fêtarde
gabonais|gabonaise
gaga|gaga
gagnant|gagnante
gai|gaie
gaillard|gaillarde
galactique|galactique
galant|galante
galicien|galicienne
gallican|gallicane
gallique|gallique
gallois|galloise
galopant|galopante
ganglionnaire|ganglionnaire
garance|garance
garant|garante
gardois|gardoise
garibaldien|garibaldienne
gascon|gasconne
gaspilleur|gaspilleuse
gastrique|gastrique
gastritique|gastritique
gastronomique|gastronomique
gauche|gauche
gauchiste|gauchiste
gaullien|gaullienne
gaulliste|gaulliste
gaulois|gauloise
gay|gay
gazeux|gazeuse
gaélique|gaélique
genevois|genevoise
gentil|gentille
germain|germaine
germanique|germanique
germé|germée
gestuel|gestuelle
giboyeux|giboyeuse
gigantesque|gigantesque
gigogne|gigogne
gingival|gingivale
ginguet|ginguette
girond|gironde
gisant|gisante
giscardien|giscardienne
glabre|glabre
glaciaire|glaciaire
glacial|glaciale
glauque|glauque
glial|gliale
glissant|glissante
global|globale
globalisant|globalisante
globulaire|globulaire
glorieux|glorieuse
glottal|glottale
glouton|gloutonne
gluant|gluante
glénoïdal|glénoïdale
glénoïde|glénoïde
gnomique|gnomique
godiche|godiche
goguenard|goguenarde
gonflable|gonflable
gorbatchévien|gorbatchévienne
gore|gore
gorgé|gorgée
gothique|gothique
gouleyant|gouleyante
goulu|goulue
gourd|gourde
gourmand|gourmande
gourmé|gourmée
gouvernant|gouvernante
gouvernemental|gouvernementale
gracieux|gracieuse
gracile|gracile
graduel|graduelle
gradé|gradée
graisseux|graisseuse
grammatical|grammaticale
grand|grande
grandiloquent|grandiloquente
grandiose|grandiose
grandissant|grandissante
granitique|granitique
graphique|graphique
gras|grasse
grassouillet|grassouillette
gratiné|gratinée
gratuit|gratuite
grave|grave
graveleux|graveleuse
gravimétrique|gravimétrique
gravissime|gravissime
grec|grecque
grenadin|grenadine
grenat|grenat
grenoblois|grenobloise
grenu|grenue
grené|grenée
grimaçant|grimaçante
grincheux|grincheuse
grinçant|grinçante
grippal|grippale
gris|grise
grisard|grisarde
grison|grisonne
grisonnant|grisonnante
grisouteux|grisouteuse
grisâtre|grisâtre
grièche|grièche
grognon|grognonne
gros|grosse
grossier|grossière
grotesque|grotesque
grouillant|grouillante
grumeleux|grumeleuse
grège|grège
grégaire|grégaire
grégorien|grégorienne
gréviste|gréviste
grêle|grêle
guadeloupéen|guadeloupéenne
guatémaltèque|guatémaltèque
guerrier|guerrière
gueulard|gueularde
guilleret|guillerette
gummifère|gummifère
guttural|gutturale
guyanais|guyanaise
gynécologique|gynécologique
gâteux|gâteuse
géant|géante
gélatineux|gélatineuse
gémellaire|gémellaire
génial|géniale
génital|génitale
généalogique|généalogique
général|générale
généraliste|généraliste
générateur|génératrice
généreux|généreuse
générique|générique
génétique|génétique
géographique|géographique
géologique|géologique
géométrique|géométrique
géopolitique|géopolitique
géorgien|géorgienne
géorgique|géorgique
géostationnaire|géostationnaire
géostratégique|géostratégique
géothermique|géothermique
gênant|gênante
habile|habile
habitable|habitable
habituel|habituelle
habité|habitée
hachuré|hachurée
hadal|hadale
hadronique|hadronique
hagard|hagarde
haillonneux|haillonneuse
haineux|haineuse
haletant|haletante
halieutique|halieutique
hallal|hallal
hallucinant|hallucinante
hallucinogène|hallucinogène
halogène|halogène
halogéné|halogénée
hambourgeois|hambourgeoise
handicapé|handicapée
hardi|hardie
hargneux|hargneuse
harmonieux|harmonieuse
harriste|harriste
hasardeux|hasardeuse
haussier|haussière
haut|haute
hautain|hautaine
hauturier|hauturière
havane|havane
haïssable|haïssable
haïtien|haïtienne
hebdomadaire|hebdomadaire
hellène|hellène
hellénique|hellénique
helvétique|helvétique
herbeux|herbeuse
herculéen|herculéenne
hercynien|hercynienne
hermaphrodite|hermaphrodite
herméneutique|herméneutique
hermétique|hermétique
hernusien|hernusienne
hertzien|hertzienne
heureux|heureuse
heuristique|heuristique
hexagonal|hexagonale
hexamètre|hexamètre
hibernal|hibernale
hideux|hideuse
hilarant|hilarante
hilare|hilare
hindou|hindoue
hippique|hippique
hippomobile|hippomobile
hippophagique|hippophagique
hircin|hircine
hirsute|hirsute
hispanique|hispanique
historiographique|historiographique
historique|historique
hitchcockien|hitchcockienne
hitlérien|hitlérienne
hivernal|hivernale
hiémal|hiémale
hiérarchique|hiérarchique
hiératique|hiératique
hollandais|hollandaise
hollywoodien|hollywoodienne
homogène|homogène
homologue|homologue
homonyme|homonyme
homophone|homophone
homorozygote|homorozygote
homosexuel|homosexuelle
homérique|homérique
hondurien|hondurienne
hongrois|hongroise
honnête|honnête
honorable|honorable
honoraire|honoraire
honorifique|honorifique
honteux|honteuse
horaire|horaire
horizontal|horizontale
hormonal|hormonale
horrible|horrible
horrifique|horrifique
horticole|horticole
hospitalier|hospitalière
hostile|hostile
houiller|houillère
houleux|houleuse
huileux|huileuse
huilier|huilière
huilé|huilée
humain|humaine
humaniste|humaniste
humanitaire|humanitaire
humble|humble
humide|humide
humiliant|humiliante
humoral|humorale
humoristique|humoristique
huméral|humérale
hun|hun
huppé|huppée
hurlant|hurlante
hyalin|hyaline
hybride|hybride
hydraulique|hydraulique
hydrique|hydrique
hydrographique|hydrographique
hydrogéologique|hydrogéologique
hydrologique|hydrologique
hydrométrique|hydrométrique
hydroélectrique|hydroélectrique
hygiénique|hygiénique
hygiéniste|hygiéniste
hypercorrect|hypercorrecte
hypermétrope|hypermétrope
hypernerveux|hypernerveuse
hypertrophié|hypertrophiée
hypnotique|hypnotique
hypocrite|hypocrite
hypophysaire|hypophysaire
hypostyle|hypostyle
hypothécaire|hypothécaire
hypothétique|hypothétique
hypoïde|hypoïde
hystérique|hystérique
hâbleur|hâbleuse
hâtif|hâtive
hâve|hâve
hébraïque|hébraïque
hégémonique|hégémonique
hélicoïdal|hélicoïdale
héliographique|héliographique
héliomarin|héliomarine
hémisphérique|hémisphérique
hémolytique|hémolytique
hémostatique|hémostatique
hépatique|hépatique
héraldique|héraldique
héroïque|héroïque
héréditaire|héréditaire
hérétique|hérétique
hésitant|hésitante
hétéroclite|hétéroclite
hétérodoxe|hétérodoxe
hétérogène|hétérogène
hétérosexuel|hétérosexuelle
hétérozygote|hétérozygote
ibérique|ibérique
iconique|iconique
identifiable|identifiable
identifié|identifiée
identique|identique
identitaire|identitaire
idiomatique|idiomatique
idiot|idiote
idoine|idoine
idolâtre|idolâtre
idyllique|idyllique
idéal|idéale
idéaliste|idéaliste
idéologique|idéologique
ignare|ignare
ignoble|ignoble
ignominieux|ignominieuse
igné|ignée
iliaque|iliaque
illettré|illettrée
illicite|illicite
illimité|illimitée
illisible|illisible
illogique|illogique
illusoire|illusoire
illustre|illustre
illégal|illégale
illégitime|illégitime
imageux|imageuse
imaginable|imaginable
imaginaire|imaginaire
imaginatif|imaginative
imagé|imagée
imbattable|imbattable
imberbe|imberbe
imbu|imbue
imbuvable|imbuvable
imbécile|imbécile
immaculé|immaculée
immanent|immanente
immangeable|immangeable
immanquable|immanquable
immature|immature
immatériel|immatérielle
immense|immense
immettable|immettable
immeuble|immeuble
imminent|imminente
immobile|immobile
immobilier|immobilière
immodeste|immodeste
immodéré|immodérée
immonde|immonde
immoral|immorale
immortel|immortelle
immuable|immuable
immunitaire|immunitaire
immunologique|immunologique
immédiat|immédiate
immémorial|immémoriale
immérité|imméritée
impair|impaire
impalpable|impalpable
imparable|imparable
impardonnable|impardonnable
imparfait|imparfaite
impartageable|impartageable
impartial|impartiale
impassible|impassible
impatient|impatiente
impatienté|impatientée
impavide|impavide
impayable|impayable
impayé|impayée
impeccable|impeccable
impensable|impensable
imperceptible|imperceptible
imperdable|imperdable
imperfectible|imperfectible
imperméable|imperméable
impersonnel|impersonnelle
impertinent|impertinente
imperturbable|imperturbable
impie|impie
impitoyable|impitoyable
implacable|implacable
implantable|implantable
implicite|implicite
implorant|implorante
impoli|impolie
impolitique|impolitique
impondérable|impondérable
impopulaire|impopulaire
importable|importable
important|importante
importateur|importatrice
importun|importune
imposable|imposable
imposant|imposante
impossible|impossible
impotent|impotente
impraticable|impraticable
imprenable|imprenable
imprescriptible|imprescriptible
impressionnant|impressionnante
improbable|improbable
improductif|improductive
impromptu|impromptue
imprononçable|imprononçable
impropre|impropre
improuvable|improuvable
imprudent|imprudente
imprécis|imprécise
imprécisable|imprécisable
imprévisible|imprévisible
imprévoyant|imprévoyante
imprévu|imprévue
impubère|impubère
impudent|impudente
impudique|impudique
impuissant|impuissante
impulsif|impulsive
impuni|impunie
impur|impure
imputable|imputable
imputrescible|imputrescible
impécunieux|impécunieuse
impénitent|impénitente
impénétrable|impénétrable
impératif|impérative
impérial|impériale
impérialiste|impérialiste
impérieux|impérieuse
impérissable|impérissable
impétueux|impétueuse
inabordable|inabordable
inacceptable|inacceptable
inaccessible|inaccessible
inaccoutumé|inaccoutumée
inachevé|inachevée
inactif|inactive
inadapté|inadaptée
inadmissible|inadmissible
inadéquat|inadéquate
inaliénable|inaliénable
inaltérable|inaltérable
inamical|inamicale
inamovible|inamovible
inanimé|inanimée
inapaisable|inapaisable
inaperçu|inaperçue
inapparent|inapparente
inapplicable|inapplicable
inappliqué|inappliquée
inapprivoisable|inapprivoisable
inapproprié|inappropriée
inappréciable|inappréciable
inapprécié|inappréciée
inapte|inapte
inarticulé|inarticulée
inassimilable|inassimilable
inassouvi|inassouvie
inattaquable|inattaquable
inattendu|inattendue
inaudible|inaudible
inaugural|inaugurale
inavouable|inavouable
inavoué|inavouée
inca|inca
incalculable|incalculable
incandescent|incandescente
incapable|incapable
incarnat|incarnate
incassable|incassable
incendiaire|incendiaire
incertain|incertaine
incessant|incessante
incessible|incessible
inchangé|inchangée
inchoatif|inchoative
incident|incidente
incisif|incisive
incitatif|incitative
incivil|incivile
inclassable|inclassable
inclément|inclémente
incoercible|incoercible
incohérent|incohérente
incolore|incolore
incombustible|incombustible
incommensurable|incommensurable
incommode|incommode
incommunicable|incommunicable
incomparable|incomparable
incompatible|incompatible
incomplet|incomplète
incompressible|incompressible
incompris|incomprise
incompréhensible|incompréhensible
incomptable|incomptable
incompétent|incompétente
inconcevable|inconcevable
inconciliable|inconciliable
inconditionnel|inconditionnelle
inconditionné|inconditionnée
inconfortable|inconfortable
incongru|incongrue
inconnu|inconnue
inconscient|inconsciente
inconsidéré|inconsidérée
inconsistant|inconsistante
inconsolé|inconsolée
inconstant|inconstante
inconstitutionnel|inconstitutionnelle
inconstructible|inconstructible
inconséquent|inconséquente
incontestable|incontestable
incontesté|incontestée
incontinent|incontinente
incontournable|incontournable
incontrôlable|incontrôlable
incontrôlé|incontrôlée
inconvenant|inconvenante
inconvertible|inconvertible
incorporel|incorporelle
incorrect|incorrecte
incorrigible|incorrigible
incorruptible|incorruptible
increvable|increvable
incrochetable|incrochetable
incroyable|incroyable
incrédule|incrédule
inculte|inculte
incultivable|incultivable
incurable|incurable
indemne|indemne
indemnitaire|indemnitaire
indescriptible|indescriptible
indestructible|indestructible
indianisé|indianisée
indicateur|indicatrice
indicatif|indicative
indiciaire|indiciaire
indicible|indicible
indien|indienne
indifférent|indifférente
indigent|indigente
indigeste|indigeste
indigne|indigne
indigo|indigo
indigène|indigène
indirect|indirecte
indiscernable|indiscernable
indiscret|indiscrète
indiscutable|indiscutable
indiscuté|indiscutée
indispensable|indispensable
indisponible|indisponible
indissociable|indissociable
indissoluble|indissoluble
indistinct|indistincte
individualiste|individualiste
individuel|individuelle
indivis|indivise
indivisible|indivisible
indocile|indocile
indolent|indolente
indolore|indolore
indomptable|indomptable
indompté|indomptée
indonésien|indonésienne
indu|indue
indubitable|indubitable
indulgent|indulgente
induré|indurée
industriel|industrielle
industrieux|industrieuse
indécent|indécente
indéchiffrable|indéchiffrable
indéchirable|indéchirable
indécidable|indécidable
indécis|indécise
indéclinable|indéclinable
indécollable|indécollable
indécomposable|indécomposable
indécrottable|indécrottable
indéfectible|indéfectible
indéfendable|indéfendable
indéfini|indéfinie
indéfinissable|indéfinissable
indéformable|indéformable
indélicat|indélicate
indélébile|indélébile
indéniable|indéniable
indénombrable|indénombrable
indépassable|indépassable
indépendant|indépendante
indépendantiste|indépendantiste
indéracinable|indéracinable
indésirable|indésirable
indéterminé|indéterminée
ineffable|ineffable
ineffaçable|ineffaçable
inefficace|inefficace
inemployé|inemployée
inentamable|inentamable
inepte|inepte
inerte|inerte
inertiel|inertielle
inespéré|inespérée
inestimable|inestimable
inexact|inexacte
inexcusable|inexcusable
inexercé|inexercée
inexigible|inexigible
inexistant|inexistante
inexorable|inexorable
inexpié|inexpiée
inexplicable|inexplicable
inexpliqué|inexpliquée
inexploité|inexploitée
inexploré|inexplorée
inexpressif|inexpressive
inexprimé|inexprimée
inexpugnable|inexpugnable
inexpérimenté|inexpérimentée
inextensible|inextensible
inextinguible|inextinguible
inextricable|inextricable
infaillible|infaillible
infaisable|infaisable
infamant|infamante
infanticide|infanticide
infantile|infantile
infatigable|infatigable
infect|infecte
infectieux|infectieuse
infernal|infernale
infertile|infertile
infidèle|infidèle
infime|infime
infini|infinie
infinitif|infinitive
infinitésimal|infinitésimale
infirme|infirme
infirmier|infirmière
inflammable|inflammable
inflationniste|inflationniste
inflexible|inflexible
influent|influente
infondé|infondée
informatif|informative
informatisé|informatisée
informe|informe
informel|informelle
informulé|informulée
infortuné|infortunée
infractionnel|infractionnelle
infranchissable|infranchissable
infrarouge|infrarouge
infrarégional|infrarégionale
infrastructurel|infrastructurelle
infroissable|infroissable
infructueux|infructueuse
infréquentable|infréquentable
infumable|infumable
infus|infuse
infusible|infusible
infâme|infâme
infécond|inféconde
inférieur|inférieure
ingagnable|ingagnable
ingambe|ingambe
ingouvernable|ingouvernable
ingrat|ingrate
inguinal|inguinale
inguérissable|inguérissable
ingénieux|ingénieuse
ingénu|ingénue
ingérable|ingérable
inhabile|inhabile
inhabitable|inhabitable
inhabituel|inhabituelle
inhabité|inhabitée
inharmonieux|inharmonieuse
inhumain|inhumaine
inhérent|inhérente
inimaginable|inimaginable
inimitable|inimitable
inimité|inimitée
ininflammable|ininflammable
inintelligent|inintelligente
inintelligible|inintelligible
ininterrompu|ininterrompue
inintéressant|inintéressante
inique|inique
initial|initiale
initiatique|initiatique
injoignable|injoignable
injouable|injouable
injuste|injuste
injustifiable|injustifiable
injustifié|injustifiée
inlassable|inlassable
innocent|innocente
innombrable|innombrable
innommable|innommable
innommé|innommée
innomé|innomée
innovant|innovante
innovateur|innovatrice
inné|innée
inobservé|inobservée
inoccupé|inoccupée
inodore|inodore
inoffensif|inoffensive
inopiné|inopinée
inopportun|inopportune
inopposable|inopposable
inopérable|inopérable
inopérant|inopérante
inorganisé|inorganisée
inoubliable|inoubliable
inouï|inouïe
inoxydable|inoxydable
inqualifiable|inqualifiable
inquiet|inquiète
inquisiteur|inquisitrice
inquisitorial|inquisitoriale
inquiétant|inquiétante
insaisissable|insaisissable
insalissable|insalissable
insalubre|insalubre
insane|insane
insatiable|insatiable
insatisfaisant|insatisfaisante
insatisfait|insatisfaite
insecticide|insecticide
insensible|insensible
insensé|insensée
insidieux|insidieuse
insigne|insigne
insignifiant|insignifiante
insipide|insipide
insistant|insistante
insolent|insolente
insolite|insolite
insoluble|insoluble
insolvable|insolvable
insomniaque|insomniaque
insondable|insondable
insonore|insonore
insouciant|insouciante
insoumis|insoumise
insoupçonné|insoupçonnée
insoutenable|insoutenable
instable|instable
instant|instante
instantané|instantanée
instinctif|instinctive
institutionnel|institutionnelle
instructif|instructive
instrumental|instrumentale
insubmersible|insubmersible
insubordonné|insubordonnée
insuffisant|insuffisante
insulaire|insulaire
insupportable|insupportable
insurmontable|insurmontable
insurrectionnel|insurrectionnelle
inséparable|inséparable
intact|intacte
intangible|intangible
intarissable|intarissable
intellectuel|intellectuelle
intelligent|intelligente
intelligible|intelligible
intempestif|intempestive
intemporel|intemporelle
intempérant|intempérante
intenable|intenable
intense|intense
intensif|intensive
intensif|intensives
intentionnel|intentionnelle
interactif|interactive
interactif|interactives
interallié|interalliée
interaméricain|interaméricaine
interarmes|interarmes
interbancaire|interbancaire
interchangeable|interchangeable
interclubs|interclubs
intercommunal|intercommunale
intercommunautaire|intercommunautaire
intercontinental|intercontinentale
intercostal|intercostale
interdisciplinaire|interdisciplinaire
interdépendant|interdépendante
interethnique|interethnique
interfédéral|interfédérale
intergouvernemental|intergouvernementale
interinstitutionnel|interinstitutionnelle
interlibanais|interlibanaise
interlocutoire|interlocutoire
interlope|interlope
interminable|interminable
interministériel|interministérielle
intermittent|intermittente
intermédiaire|intermédiaire
international|internationale
interne|interne
interocéanique|interocéanique
interparlementaire|interparlementaire
interplanétaire|interplanétaire
interportuaire|interportuaire
interprofessionnel|interprofessionnelle
interprétatif|interprétative
interprétatif|interprétatives
interreligieux|interreligieuse
interrogatif|interrogative
interrégional|interrégionale
intersidéral|intersidérale
interstellaire|interstellaire
interstitiel|interstitielle
intersyndical|intersyndicale
interuniversitaire|interuniversitaire
interurbain|interurbaine
interventionniste|interventionniste
interétatique|interétatique
intestat|intestat
intestin|intestine
intestinal|intestinale
intime|intime
intimidant|intimidante
intimiste|intimiste
intolérable|intolérable
intolérant|intolérante
intouchable|intouchable
intoxicant|intoxicante
intracommunautaire|intracommunautaire
intraduisible|intraduisible
intraitable|intraitable
intramusculaire|intramusculaire
intransigeant|intransigeante
intransitif|intransitive
intransportable|intransportable
intrigant|intrigante
intrinsèque|intrinsèque
introductif|introductives
introuvable|introuvable
introverti|introvertie
intrus|intruse
intrépide|intrépide
intuitif|intuitive
intègre|intègre
intégral|intégrale
intégrant|intégrante
intégrationniste|intégrationniste
intégriste|intégriste
intéressant|intéressante
intérieur|intérieure
intérimaire|intérimaire
inusable|inusable
inusité|inusitée
inutile|inutile
inutilisable|inutilisable
inutilisé|inutilisée
invaincu|invaincue
invalide|invalide
invariable|invariable
invendable|invendable
invendu|invendue
inventif|inventive
inverse|inverse
invincible|invincible
inviolable|inviolable
invisible|invisible
invivable|invivable
involontaire|involontaire
invraisemblable|invraisemblable
invulnérable|invulnérable
invérifiable|invérifiable
invétéré|invétérée
inébranlable|inébranlable
inédit|inédite
inégal|inégale
inégalable|inégalable
inégalitaire|inégalitaire
inégalé|inégalée
inéligible|inéligible
inéluctable|inéluctable
inélégant|inélégante
inénarrable|inénarrable
inépuisable|inépuisable
inépuisé|inépuisée
inéquitable|inéquitable
inévitable|inévitable
ionien|ionienne
ionisant|ionisante
irakien|irakienne
iranien|iranienne
irascible|irascible
irlandais|irlandaise
ironique|ironique
iroquois|iroquoise
irraisonné|irraisonnée
irrationnel|irrationnelle
irrecevable|irrecevable
irremplaçable|irremplaçable
irrespectueux|irrespectueuse
irrespirable|irrespirable
irresponsable|irresponsable
irrigable|irrigable
irritable|irritable
irréalisable|irréalisable
irréaliste|irréaliste
irréconciliable|irréconciliable
irrécupérable|irrécupérable
irrécusable|irrécusable
irréductible|irréductible
irréel|irréelle
irréfléchi|irréfléchie
irréfutable|irréfutable
irréfuté|irréfutée
irrégulier|irrégulière
irrémissible|irrémissible
irrémédiable|irrémédiable
irréparable|irréparable
irrépressible|irrépressible
irréprochable|irréprochable
irrépréhensible|irrépréhensible
irrésistible|irrésistible
irrésolu|irrésolue
irrétrécissable|irrétrécissable
irréversible|irréversible
irrévocable|irrévocable
irrévérencieux|irrévérencieuse
isabelle|isabelle
islamique|islamique
islamiste|islamiste
islamologue|islamologue
ismaélien|ismaélienne
isobare|isobare
isoclinal|isoclinale
isocèle|isocèle
isoglosse|isoglosse
isomorphe|isomorphe
isomère|isomère
isotope|isotope
isotopique|isotopique
israélien|israélienne
israélite|israélite
issu|issue
istrien|istrienne
italien|italienne
itinérant|itinérante
ivoirien|ivoirienne
ivre|ivre
jaloux|jalouse
japonais|japonaise
jaune|jaune
jaunâtre|jaunâtre
jeune|jeune
jeunet|jeunette
jeunot|jeunotte
jobard|jobarde
joli|jolie
jonché|jonchée
jonquille|jonquille
jordanien|jordanienne
jospiniste|jospiniste
jouable|jouable
joueur|joueuse
joufflu|joufflue
journalier|journalière
journalistique|journalistique
jovial|joviale
joyeux|joyeuse
judaïque|judaïque
judiciaire|judiciaire
judicieux|judicieuse
jugulaire|jugulaire
juif|juive
jumeau|jumelle
junior|junior
juridictionnel|juridictionnelle
juridique|juridique
juré|jurée
juste|juste
justiciable|justiciable
justicialiste|justicialiste
justifiable|justifiable
justificatif|justificatives
juteux|juteuse
juvénile|juvénile
juxtalinéaire|juxtalinéaire
kabyle|kabyle
kaki|kaki
kanak|kanake
karstique|karstique
kascher|kascher
keynésien|keynésienne
khmer|khmère
khédival|khédivale
khédivial|khédiviale
kilométrique|kilométrique
kitsch|kitsch
koweïtien|koweïtienne
kurde|kurde
labial|labiale
labile|labile
laborieux|laborieuse
lacanien|lacanienne
laconique|laconique
lacrymal|lacrymale
lacrymogène|lacrymogène
lacté|lactée
lacunaire|lacunaire
lacustre|lacustre
ladre|ladre
lagunaire|lagunaire
lai|laie
laid|laide
laissé|laissée
laiteux|laiteuse
laitier|laitière
lambin|lambine
lamentable|lamentable
lampant|lampante
lancinant|lancinante
landais|landaise
languissant|languissante
lanifère|lanifère
lanigère|lanigère
laotien|laotienne
lapidaire|lapidaire
lapon|lapone
lapon|laponne
lare|lare
large|large
larvaire|larvaire
larvé|larvée
laryngé|laryngée
las|lasse
lascif|lascive
lassant|lassante
lassé|lassée
latent|latente
latin|latine
latéral|latérale
laudateur|laudatrice
laudatif|laudative
lauré|laurée
lauréat|lauréate
lavable|lavable
laxatif|laxative
laxiste|laxiste
laïc|laïque
laïque|laïque
ledit|ladite
lent|lente
lesbien|lesbienne
leste|leste
lesté|lestée
letton|lettone
letton|lettonne
lettré|lettrée
levant|levante
levantin|levantine
lexical|lexicale
libanais|libanaise
libertaire|libertaire
libertin|libertine
libidinal|libidinale
libidineux|libidineuse
libre|libre
libyen|libyenne
libérable|libérable
libéral|libérale
libérateur|libératrice
libératoire|libératoire
libérien|libérienne
licencieux|licencieuse
licencié|licenciée
licite|licite
lige|lige
ligneux|ligneuse
ligure|ligure
lilial|liliale
lilliputien|lilliputienne
lillois|lilloise
liminaire|liminaire
liminal|liminale
limitatif|limitatives
limitrophe|limitrophe
limoneux|limoneuse
limpide|limpide
lingual|linguale
linguistique|linguistique
linéaire|linéaire
lippu|lippue
liquidatif|liquidative
liquide|liquide
liquoreux|liquoreuse
lisible|lisible
lisse|lisse
litigieux|litigieuse
littoral|littorale
littéraire|littéraire
littéral|littérale
lituanien|lituanienne
livide|livide
livrable|livrable
local|locale
locatif|locative
logarithmique|logarithmique
logique|logique
lointain|lointaine
loisible|loisible
lombard|lombarde
londonien|londonienne
long|longue
longiligne|longiligne
longitudinal|longitudinale
loquace|loquace
loqueteux|loqueteuse
lorrain|lorraine
loti|lotie
louable|louable
louche|louche
loufoque|loufoque
lourd|lourde
lourdais|lourdaise
lourdaud|lourdaude
loyal|loyale
loyaliste|loyaliste
lozérien|lozérienne
lubrifiant|lubrifiante
lubrique|lubrique
lucide|lucide
lucratif|lucrative
ludique|ludique
lugubre|lugubre
luisant|luisante
lumineux|lumineuse
lunaire|lunaire
luné|lunée
lusitanien|lusitanienne
lusophone|lusophone
lustral|lustrale
luthérien|luthérienne
lutin|lutine
luxembourgeois|luxembourgeoise
luxueux|luxueuse
luxuriant|luxuriante
lymphatique|lymphatique
lyonnais|lyonnaise
lyrique|lyrique
lâche|lâche
légal|légale
légaliste|légaliste
légendaire|légendaire
léger|légere
léger|légère
législatif|législative
légitime|légitime
légitimiste|légitimiste
légumier|légumière
lénifiant|lénifiante
léniniste|léniniste
léonin|léonine
lésionnel|lésionnelle
létal|létale
macabre|macabre
machiavélique|machiavélique
machinal|machinale
macroéconomique|macroéconomique
macédonien|macédonienne
madrilène|madrilène
madré|madrée
mafieux|mafieuse
magenta|magenta
maghrébin|maghrébine
magique|magique
magistral|magistrale
magmatique|magmatique
magnanime|magnanime
magnifique|magnifique
magnétique|magnétique
magyar|magyare
mahométan|mahométane
maigre|maigre
maigriot|maigriotte
maillant|maillante
majestueux|majestueuse
majeur|majeure
majoritaire|majoritaire
majuscule|majuscule
malabar|malabar
malade|malade
maladif|maladive
maladroit|maladroite
malaire|malaire
malais|malaise
malaisien|malaisienne
malaisé|malaisée
malappris|malapprise
malavisé|malavisée
malawien|malawienne
malbâti|malbâtie
malchanceux|malchanceuse
malcommode|malcommode
malencontreux|malencontreuse
malentendant|malentendante
malfaisant|malfaisante
malfamé|malfamée
malgache|malgache
malhabile|malhabile
malheureux|malheureuse
malhonnête|malhonnête
malicieux|malicieuse
malien|malienne
malin|maligne
malingre|malingre
malintentionné|malintentionnée
malique|malique
mallarméen|mallarméenne
malléable|malléable
malotru|malotrue
malpropre|malpropre
malsain|malsaine
malsonnant|malsonnante
malséant|malséante
maltais|maltaise
malthusien|malthusienne
malveillant|malveillante
malvenu|malvenue
maléfique|maléfique
mamelonné|mamelonnée
mammaire|mammaire
managérial|managériale
manchot|manchote
mandataire|mandataire
mandchou|mandchoue
mangeable|mangeable
maniable|maniable
maniaque|maniaque
manichéen|manichéenne
manifeste|manifeste
maniériste|maniériste
maniéré|maniérée
manquant|manquante
manuel|manuelle
manufacturier|manufacturière
manufacturé|manufacturée
manuscrit|manuscrite
maoïste|maoïste
marchand|marchande
marengo|marengo
marginal|marginale
marial|mariale
marin|marine
mariol|mariol
mariolle|mariolle
marital|maritale
maritime|maritime
marmoréen|marmoréenne
marocain|marocaine
maronite|maronite
marquant|marquante
marrant|marrante
marri|marrie
marron|marron
marron|marronne
marseillais|marseillaise
martial|martiale
martien|martienne
martiniquais|martiniquaise
martyr|martyre
marxiste|marxiste
marécageux|marécageuse
maréchaliste|maréchaliste
masculin|masculine
masochiste|masochiste
massif|massive
mastoc|mastoc
mastoïde|mastoïde
mat|mat
mat|mate
maternel|maternelle
maternisé|maternisée
mathématique|mathématique
matinal|matinale
matois|matoise
matriarcal|matriarcale
matrilocal|matrilocale
matrimonial|matrimoniale
mature|mature
matériel|matérielle
maure|maure
mauresque|mauresque
mauricien|mauricienne
mauritanien|mauritanienne
maussade|maussade
mauvais|mauvaise
mauve|mauve
maximal|maximale
maximaliste|maximaliste
maya|maya
maçonnique|maçonnique
maître|maîtresse
maîtrisable|maîtrisable
membraneux|membraneuse
menaçant|menaçante
menin|menine
mensonger|mensongère
mensuel|mensuelle
mental|mentale
menteur|menteuse
menu|menue
mercantile|mercantile
mermazien|mermazienne
merveilleux|merveilleuse
mesquin|mesquine
messianique|messianique
meuble|meuble
meurtrier|meurtrière
mexicain|mexicaine
microbien|microbienne
microbiologique|microbiologique
microscopique|microscopique
microélectronique|microélectronique
mielleux|mielleuse
mien|mienne
mien|mienne
mignard|mignarde
mignon|mignonne
mignonnet|mignonnette
migrateur|migratrice
migratoire|migratoire
milanais|milanaise
militaire|militaire
militariste|militariste
mimé|mimée
minable|minable
mince|mince
mineur|mineure
minier|minière
minimal|minimale
minimaliste|minimaliste
minimalisé|minimalisée
minime|minime
ministériel|ministérielle
minoritaire|minoritaire
minotier|minotière
minuscule|minuscule
minutieux|minutieuse
minéral|minérale
minéralisé|minéralisée
miraculeux|miraculeuse
mirifique|mirifique
mirobolant|mirobolante
miroitant|miroitante
misanthrope|misanthrope
miscible|miscible
misogyne|misogyne
missionnaire|missionnaire
misérable|misérable
miséreux|miséreuse
miteux|miteuse
mitigé|mitigée
mitoyen|mitoyenne
mitral|mitrale
mitterrandien|mitterrandienne
mitterrandiste|mitterrandiste
mixte|mixte
mièvre|mièvre
mnémotechnique|mnémotechnique
mobile|mobile
mobilier|mobilière
mobilisateur|mobilisatrice
moche|moche
modal|modale
moderne|moderne
modernisateur|modernisatrice
moderniste|moderniste
modeste|modeste
modique|modique
modulaire|modulaire
modéré|modérée
moelleux|moelleuse
moite|moite
moluquois|moluquoise
moléculaire|moléculaire
momentané|momentanée
monacal|monacale
monarchique|monarchique
monastique|monastique
monaural|monaurale
mondain|mondaine
mondial|mondiale
mondialiste|mondialiste
mondialisé|mondialisée
mongol|mongole
monobloc|monobloc
monochrome|monochrome
monoclinal|monoclinale
monocoque|monocoque
monocorde|monocorde
monographique|monographique
monolingue|monolingue
monolithique|monolithique
monomoteur|monomoteur
monoparental|monoparentale
monoplace|monoplace
monopolistique|monopolistique
monotone|monotone
monovalent|monovalente
monozygote|monozygote
monstrueux|monstrueuse
montagnard|montagnarde
montagneux|montagneuse
montant|montante
montpelliérain|montpelliéraine
monumental|monumentale
monégasque|monégasque
monétaire|monétaire
moqueur|moqueuse
moral|morale
moraliste|moraliste
moratoire|moratoire
morbide|morbide
mordant|mordante
mordoré|mordorée
more|more
moresque|moresque
morganatique|morganatique
moribond|moribonde
moricaud|moricaude
morne|morne
morose|morose
morphologique|morphologique
mort|morte
mortel|mortelle
mortuaire|mortuaire
morutier|morutière
moscovite|moscovite
moteur|motrice
motivé|motivée
mou|molle
moulant|moulante
mourant|mourante
mousse|mousse
mousseux|mousseuse
mouvant|mouvante
mouvementé|mouvementée
moyen|moyenne
moyenâgeux|moyenâgeuse
mozarabe|mozarabe
mozartien|mozartienne
muet|muette
muletier|muletière
multicolore|multicolore
multicouche|multicouche
multicritères|multicritères
multiculturel|multiculturelle
multidimensionnel|multidimensionnelle
multidisciplinaire|multidisciplinaire
multifibre|multifibre
multiforme|multiforme
multilatéral|multilatérale
multilingue|multilingue
multimodal|multimodale
multimédia|multimédia
multinational|multinationale
multipare|multipare
multipartenaire|multipartenaire
multipartite|multipartite
multiple|multiple
multiracial|multiraciale
multirisque|multirisque
multirégional|multirégionale
multisalles|multisalles
multisectoriel|multisectorielle
mulâtre|mulâtresse
munichois|munichoise
municipal|municipale
munificent|munificente
muqueux|muqueuse
mural|murale
musculaire|musculaire
musical|musicale
musicien|musicienne
musqué|musquée
mussoliniste|mussoliniste
musulman|musulmane
mutilant|mutilante
mutin|mutine
mutualiste|mutualiste
mutuel|mutuelle
mycénien|mycénienne
myopathe|myopathe
myope|myope
mystique|mystique
mystérieux|mystérieuse
mythique|mythique
mythologique|mythologique
mythomane|mythomane
mytilicole|mytilicole
mâle|mâle
mécanique|mécanique
mécanographique|mécanographique
méchant|méchante
méconnaissable|méconnaissable
mécontent|mécontente
médaillé|médaillée
médian|médiane
médiat|médiate
médiateur|médiatrice
médiatique|médiatique
médical|médicale
médicamenteux|médicamenteuse
médicinal|médicinale
médiocre|médiocre
médisant|médisante
méditatif|méditative
méditerranéen|méditerranéenne
médiéval|médiévale
médullaire|médullaire
méfiant|méfiante
mégalomane|mégalomane
mélancolique|mélancolique
mélanésien|mélanésienne
mélioratif|méliorative
mélodique|mélodique
mélodramatique|mélodramatique
mémorable|mémorable
ménager|ménagère
méniscal|méniscale
méphistophélique|méphistophélique
méphitique|méphitique
méplat|méplate
méprisant|méprisante
méridien|méridienne
méridional|méridionale
méritant|méritante
méritoire|méritoire
métabolique|métabolique
métallique|métallique
métallurgique|métallurgique
métaphorique|métaphorique
métapsychique|métapsychique
méthodique|méthodique
méthodologique|méthodologique
méthylique|méthylique
méticuleux|méticuleuse
métis|métisse
métrique|métrique
métrologique|métrologique
métropolitain|métropolitaine
météorologique|météorologique
même|même
même|même
mûr|mûre
nacré|nacrée
nain|naine
naissant|naissante
namibien|namibienne
nanoélectronique|nanoélectronique
nantais|nantaise
napolitain|napolitaine
napoléonien|napoléonienne
narquois|narquoise
narratif|narrative
nasal|nasale
nasillard|nasillarde
natal|natale
nataliste|nataliste
natif|native
national|nationale
nationaliste|nationaliste
naturaliste|naturaliste
naturel|naturelle
nauséabond|nauséabonde
nauséeux|nauséeuse
nautique|nautique
naval|navale
navigable|navigable
navrant|navrante
nazi|nazie
naïf|naïve
nerveux|nerveuse
net|nette
neuf|neuve
neural|neurale
neuropsychique|neuropsychique
neutralisé|neutralisée
neutre|neutre
neutronique|neutronique
niable|niable
niais|niaise
nicaraguayen|nicaraguayenne
niché|nichée
nigérian|nigériane
nival|nivale
niçois|niçoise
noble|noble
nobélisable|nobélisable
nocif|nocive
noctambule|noctambule
nocturne|nocturne
nodal|nodale
noir|noire
noiraud|noiraude
noirâtre|noirâtre
nomade|nomade
nombreux|nombreuse
nominal|nominale
nominatif|nominative
nonagénaire|nonagénaire
nonchalant|nonchalante
nord|nord
nordique|nordique
nordiste|nordiste
normal|normale
normand|normande
normatif|normative
norvégien|norvégienne
nosocomial|nosocomiale
nostalgique|nostalgique
notable|notable
notarial|notariale
notionnel|notionnelle
notoire|notoire
noueux|noueuse
nourricier|nourricière
nourrissant|nourrissante
nouveau|nouvelle
novateur|novatrice
nu|nue
nuageux|nuageuse
nubile|nubile
nucal|nucale
nucléaire|nucléaire
nuisible|nuisible
nul|nulle
nul|nulle
nullard|nullarde
numéral|numérale
numérique|numérique
nuptial|nuptiale
nutritif|nutritive
nutritionnel|nutritionnelle
nyctalope|nyctalope
nymphal|nymphale
nécessaire|nécessaire
nécessiteux|nécessiteuse
néerlandais|néerlandaise
néfaste|néfaste
négatif|négative
négligeable|négligeable
négligent|négligente
négociable|négociable
néoclassique|néoclassique
néogrec|néogrecque
néohellénique|néohellénique
néolithique|néolithique
néonatal|néonatale
néonazi|néonazie
néoréaliste|néoréaliste
néostalinien|néostalinienne
népalais|népalaise
néphrétique|néphrétique
néritique|néritique
névralgique|névralgique
névropathe|névropathe
névrotique|névrotique
objectal|objectale
objectif|objective
objectif|objectives
obligataire|obligataire
obligatoire|obligatoire
obligeant|obligeante
oblique|oblique
oblong|oblongue
obscur|obscure
obscurantiste|obscurantiste
obscène|obscène
observateur|observatrice
observatoire|observatoire
obsessionnel|obsessionnelle
obsidional|obsidionale
obsolescent|obsolescente
obsolète|obsolète
obstétrical|obstétricale
obsédant|obsédante
obséquieux|obséquieuse
obtus|obtuse
obèse|obèse
occasionnel|occasionnelle
occidental|occidentale
occipital|occipitale
occitan|occitane
occlusif|occlusive
occulte|occulte
occurrent|occurrente
ocre|ocre
octal|octale
octogonal|octogonale
octogénaire|octogénaire
octosyllabe|octosyllabe
oculaire|oculaire
océanien|océanienne
océanique|océanique
océanographique|océanographique
odieux|odieuse
odorant|odorante
odoriférant|odoriférante
oecuménique|oecuménique
oedémateux|oedémateuse
oestral|oestrale
off|off
offensif|offensive
officiel|officielle
officieux|officieuse
officinal|officinale
offrant|offrante
offshore|offshore
ogival|ogivale
oiseux|oiseuse
oisif|oisive
olfactif|olfactive
oligocène|oligocène
olivâtre|olivâtre
olographe|olographe
olympique|olympique
oléagineux|oléagineuse
oléicole|oléicole
ombilical|ombilicale
ombrageux|ombrageuse
ombrophile|ombrophile
omnidirectionnel|omnidirectionnelle
omnipotent|omnipotente
omniprésent|omniprésente
omniscient|omnisciente
omnisports|omnisports
omnivore|omnivore
oncial|onciale
oncogène|oncogène
oncologique|oncologique
onctueux|onctueuse
ondulant|ondulante
ondulatoire|ondulatoire
onduleux|onduleuse
onirique|onirique
ontologique|ontologique
onusien|onusienne
onéreux|onéreuse
opalin|opaline
opaque|opaque
opiacé|opiacée
opiniâtre|opiniâtre
opportun|opportune
opportuniste|opportuniste
opposable|opposable
oppositionnel|oppositionnelle
opposé|opposée
optimal|optimale
optimiste|optimiste
optionnel|optionnelle
opulent|opulente
opéable|opéable
opérationnel|opérationnelle
opératoire|opératoire
orageux|orageuse
oral|orale
orange|orange
orangé|orangée
oratoire|oratoire
orbiculaire|orbiculaire
orbitaire|orbitaire
orbital|orbitale
orchestral|orchestrale
ordinaire|ordinaire
ordinal|ordinale
ordonnateur|ordonnatrice
organique|organique
organisationnel|organisationnelle
orgueilleux|orgueilleuse
oriental|orientale
orientaliste|orientaliste
originaire|originaire
original|originale
originel|originelle
ornemental|ornementale
ornithologique|ornithologique
orphique|orphique
orthodoxe|orthodoxe
orthogonal|orthogonale
orthopédique|orthopédique
osseux|osseuse
ostensible|ostensible
ostentatoire|ostentatoire
ostréicole|ostréicole
ottoman|ottomane
ouest|ouest
ougandais|ougandaise
outillé|outillée
outragé|outragée
outrancier|outrancière
outrecuidant|outrecuidante
outremer|outremer
ouvert|ouverte
ouvrant|ouvrante
ouvrier|ouvrière
ovale|ovale
ovin|ovine
ovipare|ovipare
ovovivipare|ovovivipare
oxhydrique|oxhydrique
pachydermique|pachydermique
pacifique|pacifique
pacifiste|pacifiste
paf|paf
paillard|paillarde
pair|paire
paisible|paisible
pakistanais|pakistanaise
palangrier|palangrière
palatal|palatale
palatial|palatiale
palatin|palatine
palestinien|palestinienne
pali|palie
palléal|palléale
palmaire|palmaire
palmé|palmée
palpable|palpable
palpitant|palpitante
palpébral|palpébrale
paludéen|paludéenne
palustre|palustre
paléolithique|paléolithique
pamphlétaire|pamphlétaire
panafricain|panafricaine
panaméen|panaméenne
panaméricain|panaméricaine
panard|panarde
panchromatique|panchromatique
paneuropéen|paneuropéen
paneuropéen|paneuropéenne
panhellénique|panhellénique
panifiable|panifiable
panislamique|panislamique
panoramique|panoramique
panslave|panslave
pansu|pansue
pantagruélique|pantagruélique
pantelant|pantelante
panthéiste|panthéiste
pantois|pantoise
papal|papale
papelard|papelarde
papou|papoue
paradoxal|paradoxale
parafiscal|parafiscale
parallèle|parallèle
paralysant|paralysante
paralytique|paralytique
paramilitaire|paramilitaire
paramédical|paramédicale
paranormal|paranormale
paranoïaque|paranoïaque
paraphernal|paraphernale
paraphé|paraphée
parapétrolier|parapétrolière
parasitaire|parasitaire
parasite|parasite
parasiticide|parasiticide
parasympathique|parasympathique
parcellaire|parcellaire
parcimonieux|parcimonieuse
pareil|pareille
parental|parentale
parentéral|parentérale
paresseux|paresseuse
parfait|parfaite
parisien|parisienne
parisis|parisis
parisyllabique|parisyllabique
paritaire|paritaire
pariétaire|pariétaire
pariétal|pariétale
parlant|parlante
parlementaire|parlementaire
parodique|parodique
parodontal|parodontale
paroissial|paroissiale
paroxysmal|paroxysmale
paroxysmique|paroxysmique
paroxystique|paroxystique
parsi|parsie
partenarial|partenariale
partial|partiale
participant|participante
participatif|participatives
participial|participiale
particulier|particulière
partiel|partielle
partisan|partisane
partitif|partitive
partitocratique|partitocratique
parégorique|parégorique
pascal|pascale
passable|passable
passager|passagère
passible|passible
passif|passive
passionnant|passionnante
passionnel|passionnelle
passé|passée
pastoral|pastorale
pataud|pataude
patelin|pateline
patent|patente
paterne|paterne
paternel|paternelle
pathogène|pathogène
pathologique|pathologique
pathétique|pathétique
patibulaire|patibulaire
patient|patiente
patraque|patraque
patriarcal|patriarcale
patrilocal|patrilocale
patrimonial|patrimoniale
patriote|patriote
patriotique|patriotique
patronal|patronale
patronnesse|patronnesse
pauvre|pauvre
pavillonnaire|pavillonnaire
payable|payable
payant|payante
paysager|paysager
pectoral|pectorale
pelucheux|pelucheuse
penaud|penaude
pensant|pensante
pensionné|pensionnée
perceptible|perceptible
perclus|percluse
percutant|percutante
percutané|percutanée
perfectible|perfectible
perfide|perfide
performant|performante
performatif|performative
permanent|permanente
permis|permise
permissible|permissible
permissif|permissive
permissif|permissives
perméable|perméable
pernicieux|pernicieuse
perpendiculaire|perpendiculaire
perplexe|perplexe
perpétuel|perpétuelle
persan|persane
persique|persique
persistant|persistante
personnel|personnelle
perspectif|perspective
perspicace|perspicace
persévérant|persévérante
pertinent|pertinente
perturbateur|perturbatrice
pervers|perverse
perçant|perçante
pesant|pesante
pessimiste|pessimiste
pestilentiel|pestilentielle
petiot|petiote
petit|petite
peuplé|peuplée
peureux|peureuse
phalangiste|phalangiste
pharamineux|pharamineuse
pharmaceutique|pharmaceutique
pharmacologique|pharmacologique
pharyngien|pharyngienne
philantropique|philantropique
philathélique|philathélique
philatélique|philatélique
philharmonique|philharmonique
philippin|philippine
philosophe|philosophe
philosophique|philosophique
phonétique|phonétique
phosphorescent|phosphorescente
phosphorique|phosphorique
photochimique|photochimique
photographique|photographique
photogénique|photogénique
photovoltaïque|photovoltaïque
photoélectrique|photoélectrique
phrygien|phrygienne
phréatique|phréatique
phtisique|phtisique
physiocratique|physiocratique
physiologique|physiologique
physique|physique
phytopharmaceutique|phytopharmaceutique
phytosanitaire|phytosanitaire
phénicien|phénicienne
phénoménal|phénoménale
phénoménologique|phénoménologique
pianistique|pianistique
picard|picarde
picaresque|picaresque
picrique|picrique
pictural|picturale
pie|pie
pieux|pieuse
pigmentaire|pigmentaire
pileux|pileuse
pimpant|pimpante
pingre|pingre
pinéal|pinéale
piquante|piquante
piqueux|piqueuse
piriforme|piriforme
piscicole|piscicole
piteux|piteuse
pitoyable|pitoyable
pittoresque|pittoresque
piètre|piètre
piémontais|piémontaise
piéton|piétonne
piétonnier|piétonnière
placide|placide
plain|plaine
plaintif|plaintive
plaisant|plaisante
plan|plane
planifiable|planifiable
planificateur|planificatrice
plantureux|plantureuse
planétaire|planétaire
plasticien|plasticienne
plastique|plastique
plat|plate
platonique|platonique
plausible|plausible
plein|pleine
pleinier|pleinière
pleural|pleurale
pleurard|pleurarde
plombifère|plombifère
plongeant|plongeante
plural|plurale
pluraliste|pluraliste
pluriannuel|pluriannuelle
pluricausal|pluricausale
pluridimensionnel|pluridimensionnelle
pluridisciplinaire|pluridisciplinaire
pluriel|plurielle
plurifonds|plurifonds
plurilatéral|plurilatérale
plurirégional|plurirégionale
plurisectoriel|plurisectorielle
pluvial|pluviale
pluvieux|pluvieuse
plébiscité|plébiscitée
plébéien|plébéienne
plénier|plénière
plénipotentiaire|plénipotentiaire
pléthorique|pléthorique
pneumologique|pneumologique
podagre|podagre
pogromiste|pogromiste
poignant|poignante
pointilleux|pointilleuse
pointilliste|pointilliste
pointu|pointue
poissard|poissarde
poisseux|poisseuse
poitevin|poitevin
polaire|polaire
poli|polie
policier|policière
policé|policée
politicien|politicienne
politique|politique
polluant|polluante
pollueur|pollueuse
polonais|polonaise
poltron|poltronne
polychrome|polychrome
polycyclique|polycyclique
polyglotte|polyglotte
polygonal|polygonale
polymorphe|polymorphe
polynomial|polynomiale
polynésien|polynésienne
polyphonique|polyphonique
polysyllabe|polysyllabe
polytechnicien|polytechnicienne
polytechnique|polytechnique
polyvalent|polyvalente
polémique|polémique
pompeux|pompeuse
ponctuel|ponctuelle
pondeur|pondeuse
pondérable|pondérable
pondéral|pondérale
pontifical|pontificale
pop|pop
populaire|populaire
populiste|populiste
porcelainier|porcelainière
porcin|porcine
pornographique|pornographique
portable|portable
portant|portante
portatif|portative
portuaire|portuaire
portugais|portugaise
portuguais|portuguaise
positif|positive
positiviste|positiviste
possessif|possessive
possible|possible
postal|postale
postdoctoral|postdoctorale
posthume|posthume
postiche|postiche
postministériel|postministérielle
postnatal|postnatale
postopératoire|postopératoire
postprandial|postprandiale
postscolaire|postscolaire
postuniversitaire|postuniversitaire
postural|posturale
postérieur|postérieure
posé|posée
potable|potable
potager|potagère
potelé|potelée
potentiel|potentielle
poupin|poupine
pourpre|pourpre
poussif|poussive
poussiéreux|poussiéreuse
poétique|poétique
pragmatique|pragmatique
prandial|prandiale
praticable|praticable
pratiquant|pratiquante
pratique|pratique
premier|première
premier|première
prenant|prenante
presbytéral|presbytérale
pressant|pressante
pressé|pressée
preste|preste
prestigieux|prestigieuse
primable|primable
primaire|primaire
prime|prime
primesautier|primesautière
primipare|primipare
primitif|primitive
primordial|primordiale
princeps|princeps
princier|princière
principal|principale
printanier|printanière
prioritaire|prioritaire
prisonnier|prisonnière
privatif|privative
privilégié|privilégiée
privé|privée
probabiliste|probabiliste
probable|probable
probant|probante
probatoire|probatoire
probe|probe
problématique|problématique
processionnaire|processionnaire
processuel|processuelle
prochain|prochaine
proche|proche
procédural|procédurale
procédurier|procédurière
prodigieux|prodigieuse
prodigue|prodigue
producteur|productrice
productif|productive
productiviste|productiviste
profane|profane
professionnel|professionnelle
professoral|professorale
profitable|profitable
profond|profonde
profès|professe
prognathe|prognathe
programmable|programmable
programmateur|programmatrice
programmatique|programmatique
progressif|progressive
progressiste|progressiste
prohibitif|prohibitive
prolifique|prolifique
prolifère|prolifère
prolixe|prolixe
prometteur|prometteuse
promoteur|promotrice
promotionnel|promotionnelle
prompt|prompte
pronazi|pronazie
pronominal|pronominale
prononcé|prononcée
propagandiste|propagandiste
prophylactique|prophylactique
prophétique|prophétique
propice|propice
proportionnel|proportionnelle
proportionné|proportionnée
propre|propre
propret|proprette
propédeutique|propédeutique
prosaïque|prosaïque
prospecteur|prospectrice
prospectif|prospective
prospère|prospère
prostré|prostrée
prosyrien|prosyrienne
protecteur|protectrice
protectionniste|protectionniste
protestataire|protestataire
prothétique|prothétique
protocolaire|protocolaire
protubérant|protubérante
protéagineux|protéagineuse
protéiforme|protéiforme
proustien|proustienne
provençal|provençale
proverbial|proverbiale
providentiel|providentielle
provincial|provinciale
provisionnel|provisionnelle
provisoire|provisoire
provocant|provocante
provocateur|provocatrice
proximal|proximale
proéminent|proéminente
prude|prude
prudent|prudente
prurigineux|prurigineuse
prussien|prussienne
préalable|préalable
précaire|précaire
précieux|précieuse
précis|précise
précité|précitée
précoce|précoce
précompétitif|précompétitive
précompétitif|précompétitives
précontentieux|précontentieuse
précontractuel|précontractuelle
préconçu|préconçue
précédent|précédente
prédominant|prédominante
préencollé|préencollée
préexistant|préexistante
préfabriqué|préfabriquée
préfectoral|préfectorale
préférable|préférable
préférentiel|préférentielle
prégnant|prégnante
préhistorique|préhistorique
préjudiciable|préjudiciable
préjudiciel|préjudicielle
préliminaire|préliminaire
prématuré|prématurée
prénatal|prénatale
prénommé|prénommée
prénormatif|prénormatives
prénuptial|prénuptiale
préoccupant|préoccupante
préopératoire|préopératoire
préparatoire|préparatoire
prépondérant|prépondérante
prérévolutionnaire|prérévolutionnaire
préscolaire|préscolaire
présent|présente
présentable|présentable
présidentiable|présidentiable
présidentiel|présidentielle
présomptif|présomptive
présomptueux|présomptueuse
présélectionné|présélectionnée
prétentieux|prétentieuse
prétorien|prétorienne
prévenant|prévenante
préventif|préventive
prévisible|prévisible
prévisionnel|prévisionnelle
prévoyant|prévoyante
préélectoral|préélectorale
prééminent|prééminente
prêt|prête
psychanalytique|psychanalytique
psychiatrique|psychiatrique
psychique|psychique
psychologique|psychologique
psychosocial|psychosociale
psychosomatique|psychosomatique
psychotique|psychotique
psychédélique|psychédélique
pubescent|pubescente
public|publique
publicitaire|publicitaire
pubère|pubère
pudique|pudique
puerpéral|puerpérale
pugnace|pugnace
puissant|puissante
pulmonaire|pulmonaire
pulpeux|pulpeuse
pulvérulent|pulvérulente
punissable|punissable
punitif|punitives
pur|pure
puritain|puritaine
purpurin|purpurine
purulent|purulente
pusillanime|pusillanime
putatif|putative
putrescible|putrescible
putride|putride
puéril|puérile
puîné|puînée
pyramidal|pyramidale
pyrolytique|pyrolytique
pâle|pâle
pâlissant|pâlissante
pâlot|pâlotte
pâteux|pâteuse
pécuniaire|pécuniaire
pédagogique|pédagogique
pédant|pédante
pédestre|pédestre
pédiatrique|pédiatrique
péjoratif|péjorative
pékinois|pékinoise
pélagique|pélagique
pélasgien|pélasgienne
pélasgique|pélasgique
pénal|pénale
pénalisant|pénalisante
pénible|pénible
péninsulaire|péninsulaire
pénitentiaire|pénitentiaire
pénultième|pénultième
pénétrant|pénétrante
péremptoire|péremptoire
pérenne|pérenne
péridural|péridurale
périlleux|périlleuse
périnatal|périnatale
périnéal|périnéale
périodique|périodique
périphérique|périphérique
périssable|périssable
péristaltique|péristaltique
péroniste|péroniste
péruvien|péruvienne
pétainiste|pétainiste
pétant|pétante
pétillant|pétillante
pétrochimique|pétrochimique
pétrolier|pétrolière
pétulant|pétulante
quadragésimal|quadragésimale
quadrangulaire|quadrangulaire
quadriennal|quadriennale
quadrilatéral|quadrilatérale
quadripartite|quadripartite
quadriplace|quadriplace
quadruple|quadruple
qualifiable|qualifiable
qualifiant|qualifiante
qualificatif|qualificative
qualitatif|qualitative
quantique|quantique
quantitatif|quantitative
quelconque|quelconque
quiet|quiète
quinaud|quinaude
quinquennal|quinquennale
quinteux|quinteuse
quintuple|quintuple
quitte|quitte
quotidien|quotidienne
québecois|québecoise
québécois|québécoise
rabbinique|rabbinique
rabelaisien|rabelaisienne
rabique|rabique
raboteux|raboteuse
rachidien|rachidienne
rachitique|rachitique
racial|raciale
raciste|raciste
racontable|racontable
racémique|racémique
radial|radiale
radiant|radiante
radical|radicale
radicant|radicante
radieux|radieuse
radin|radine
radioactif|radioactive
radiologique|radiologique
radiophonique|radiophonique
radiotoxique|radiotoxique
radiotéléphonique|radiotéléphonique
radiotélévisé|radiotélévisée
rageur|rageuse
ragot|ragote
ragoûtant|ragoûtante
raide|raide
railleur|railleuse
raisonnable|raisonnable
rameux|rameuse
ramoné|ramonée
rampant|rampante
rance|rance
rancuneux|rancuneuse
rancunier|rancunière
rapace|rapace
rapide|rapide
rare|rare
rarissime|rarissime
ras|rase
rasant|rasante
rassi|rassie
rassis|rassise
rassurant|rassurante
rationaliste|rationaliste
rationnel|rationnelle
rauque|rauque
ravageur|ravageur
ravageur|ravageuse
ravi|ravie
ravissant|ravissante
rayonnant|rayonnante
rayonné|rayonnée
rayé|rayée
rebattu|rebattue
rebelle|rebelle
rebondi|rebondie
recevable|recevable
reclus|recluse
reconductible|reconductible
reconnaissable|reconnaissable
reconnaissant|reconnaissante
reconventionnel|reconventionnelle
recru|recrue
recrudescent|recrudescente
rectal|rectale
rectangulaire|rectangulaire
recteur|rectrice
rectificatif|rectificative
rectificatif|rectificatives
rectiligne|rectiligne
rectoral|rectorale
recyclable|recyclable
redevable|redevable
redondant|redondante
redoutable|redoutable
reflex|reflex
regardant|regardante
regrettable|regrettable
relaps|relapse
relatif|relative
relationnel|relationnelle
relax|relax
relaxe|relaxe
religieux|religieuse
remarquable|remarquable
remboursable|remboursable
remuant|remuante
remédiable|remédiable
renaissant|renaissante
renforçateur|renforçatrice
renommé|renommée
renouvelable|renouvelable
rentable|rentable
rentrant|rentrante
repentant|repentante
replet|replète
reproducteur|reproductrice
reproductible|reproductible
représentatif|représentative
repu|repue
repérable|repérable
rescapé|rescapée
respectable|respectable
respectif|respective
respectif|respectives
respectueux|respectueuse
respiratoire|respiratoire
resplendissant|resplendissante
responsable|responsable
ressemblant|ressemblante
restant|restante
restrictif|restrictive
retardataire|retardataire
retors|retorse
revendicatif|revendicative
revigorant|revigorante
revisité|revisitée
revêche|revêche
rhodanien|rhodanienne
rhombique|rhombique
rhomboïdal|rhomboïdale
rhumatismal|rhumatismale
rhénan|rhénane
riant|riante
ribaud|ribaude
riche|riche
richissime|richissime
ridicule|ridicule
rieur|rieuse
rigide|rigide
rigolard|rigolarde
rigolo|rigolote
rigoriste|rigoriste
rigoureux|rigoureuse
rikiki|rikiki
ringard|ringarde
riquiqui|riquiqui
risible|risible
rituel|rituelle
rival|rivale
riverain|riveraine
robuste|robuste
rocambolesque|rocambolesque
rocardien|rocardienne
rocheux|rocheuse
rococo|rococo
rogatoire|rogatoire
rogue|rogue
roide|roide
romain|romaine
roman|romane
romand|romande
romanesque|romanesque
romantique|romantique
ronchon|ronchon
rond|ronde
rose|rose
roselier|roselière
rosé|rosée
rotatif|rotative
roublard|roublarde
rouge|rouge
rougeaud|rougeaude
rougeâtre|rougeâtre
roulant|roulante
roumain|roumaine
rouquin|rouquine
rouspéteur|rouspéteuse
roussâtre|roussâtre
routier|routière
roux|rousse
roué|rouée
royal|royale
royaliste|royaliste
rubicond|rubiconde
rude|rude
rudimentaire|rudimentaire
rudéral|rudérale
rugissant|rugissante
rugueux|rugueuse
ruineux|ruineuse
ruisselant|ruisselante
rupestre|rupestre
rural|rurale
russe|russe
russophone|russophone
rustaud|rustaude
rustique|rustique
rustre|rustre
rythmique|rythmique
rythmé|rythmée
râblé|râblée
râleur|râleur
réactif|réactive
réactionnaire|réactionnaire
réalisable|réalisable
réaliste|réaliste
rébarbatif|rébarbative
récalcitrant|récalcitrante
récapitulatif|récapitulatives
récent|récente
récepteur|réceptrice
récessif|récessive
récidiviste|récidiviste
réciproque|réciproque
récréatif|récréatives
récurrent|récurrente
rédactionnel|rédactionnelle
rédempteur|rédemptrice
rédhibitoire|rédhibitoire
réducteur|réductrice
réel|réelle
réflexe|réflexe
réfléchi|réfléchie
réformateur|réformatrice
réformiste|réformiste
réfrangible|réfrangible
réfringent|réfringente
réfugié|réfugiée
référendaire|référendaire
référentiel|référentielle
régicide|régicide
régional|régionale
régionaliste|régionaliste
réglementaire|réglementaire
régnant|régnante
régressif|régressive
régulateur|régulatrice
régulier|régulière
réjouissant|réjouissante
rémanent|rémanente
rémittent|rémittente
rémunérateur|rémunératrice
rénal|rénale
rénovateur|rénovatrice
réouvert|réouverte
réplétif|réplétive
répressif|répressive
réprobateur|réprobatrice
répréhensible|répréhensible
républicain|républicaine
répulsif|répulsive
réputé|réputée
répétitif|répétitive
résidant|résidante
résident|résidente
résidentiel|résidentielle
résiduaire|résiduaire
résiduel|résiduelle
résineux|résineuse
résolu|résolue
résonnant|résonnante
résultant|résultante
réticent|réticente
réticulé|réticulée
rétif|rétive
rétro|rétro
rétroactif|rétroactive
rétroflexe|rétroflexe
rétrograde|rétrograde
rétrospectif|rétrospective
réunionnais|réunionnaise
réutilisable|réutilisable
réversal|réversale
réversible|réversible
révisionniste|révisionniste
révocable|révocable
révolu|révolue
révolutionnaire|révolutionnaire
révulsé|révulsée
révélateur|révélatrice
révérenciel|révérencielle
révérencieux|révérencieuse
révérend|révérende
rééducatif|rééducatives
rêche|rêche
rêveur|rêveuse
sabbatique|sabbatique
sablonneux|sablonneuse
sacerdotal|sacerdotale
sacral|sacrale
sacramentel|sacramentelle
sacré|sacrée
sadique|sadique
sagace|sagace
sage|sage
sagittal|sagittale
saharien|saharienne
saignant|saignante
saillant|saillante
sain|saine
saint|sainte
saisonnier|saisonnière
salant|salante
salarial|salariale
salarié|salariée
sale|sale
salin|saline
salissant|salissante
salmonicole|salmonicole
salubre|salubre
salutaire|salutaire
salvadorien|salvadorienne
salvateur|salvatrice
salzbourgeois|salzbourgeoise
samaritain|samaritaine
sandiniste|sandiniste
sanglant|sanglante
sanguin|sanguine
sanguinaire|sanguinaire
sanguinolent|sanguinolente
sanitaire|sanitaire
sanscrit|sanscrite
sanskrit|sanskrite
saoudien|saoudienne
saoul|saoule
saphique|saphique
saphir|saphir
sapide|sapide
sarcastique|sarcastique
sarde|sarde
sardonique|sardonique
satanique|satanique
satané|satanée
satellitaire|satellitaire
satirique|satirique
satisfaisant|satisfaisante
sauf|sauve
saugrenu|saugrenue
saumâtre|saumâtre
sauvage|sauvage
savant|savante
savoureux|savoureuse
savoyard|savoyarde
scabreux|scabreuse
scalaire|scalaire
scalène|scalène
scandaleux|scandaleuse
scandalisé|scandalisée
scandinave|scandinave
scapulaire|scapulaire
sceptique|sceptique
schématique|schématique
sciatique|sciatique
scientifique|scientifique
scissipare|scissipare
scléral|sclérale
sclérosé|sclérosée
scolaire|scolaire
scolastique|scolastique
scratch|scratch
scrotal|scrotale
scrupuleux|scrupuleuse
sculptural|sculpturale
scélérat|scélérate
scénique|scénique
sec|sèche
secondaire|secondaire
secret|secrète
sectaire|sectaire
sectoriel|sectorielle
seigneurial|seigneuriale
sellé|sellée
semblable|semblable
semestriel|semestrielle
sempiternel|sempiternelle
senestre|senestre
senior|senior
sensationnel|sensationnelle
sensible|sensible
sensitif|sensitive
sensoriel|sensorielle
sensuel|sensuelle
sensé|sensée
sentencieux|sentencieuse
sentimental|sentimentale
septennal|septennale
septentrional|septentrionale
septique|septique
septuagénaire|septuagénaire
septuple|septuple
serbe|serbe
serein|sereine
serré|serrée
serviable|serviable
servile|servile
seul|seule
sexagénaire|sexagénaire
sexiste|sexiste
sextuple|sextuple
sexuel|sexuelle
sexy|sexy
seyant|seyante
shakespearien|shakespearienne
siamois|siamoise
sibilant|sibilante
sibyllin|sibylline
sibérien|sibérienne
sidéral|sidérale
sidérurgique|sidérurgique
sien|sienne
sien|sienne
sifflant|sifflante
sigmoïde|sigmoïde
significatif|significative
sihanoukiste|sihanoukiste
silencieux|silencieuse
simiesque|simiesque
similaire|similaire
simple|simple
simpliste|simpliste
simultané|simultanée
sincère|sincère
singulier|singulière
sinistre|sinistre
sinistré|sinistrée
sinueux|sinueuse
sinusoïdal|sinusoïdale
sirupeux|sirupeuse
sis|sise
sismal|sismale
sismique|sismique
situationniste|situationniste
skiable|skiable
slave|slave
slavophile|slavophile
slovaque|slovaque
slovène|slovène
smart|smart
sobre|sobre
sochalien|sochalienne
sociable|sociable
social|sociale
socialisant|socialisante
socialiste|socialiste
socioculturel|socioculturelle
sociologique|sociologique
sociopolitique|sociopolitique
socioprofessionnel|socioprofessionnelle
socioéconomique|socioéconomique
soigneux|soigneuse
solaire|solaire
solennel|solennelle
solidaire|solidaire
solide|solide
solipède|solipède
solitaire|solitaire
solsticial|solsticiale
soluble|soluble
solvable|solvable
somalien|somalienne
somatique|somatique
sombre|sombre
sommaire|sommaire
somnambule|somnambule
somnambulique|somnambulique
somnifère|somnifère
somnolent|somnolente
somptuaire|somptuaire
somptueux|somptueuse
songeur|songeuse
sonnant|sonnante
sonore|sonore
soporifique|soporifique
sordide|sordide
sortant|sortante
sot|sotte
soucieux|soucieuse
soudain|soudaine
soudanais|soudanaise
souffreteux|souffreteuse
souhaitable|souhaitable
souple|souple
soupçonneux|soupçonneuse
sourcilleux|sourcilleuse
sourd|sourde
souriant|souriante
sournois|sournoise
souscripteur|souscripteuse
soussigné|soussignée
soutenable|soutenable
souterrain|souterraine
souverain|souveraine
soviétiforme|soviétiforme
soviétique|soviétique
soyeux|soyeuse
soûl|soûle
spacieux|spacieuse
spasmodique|spasmodique
spatial|spatiale
spectaculaire|spectaculaire
spectral|spectrale
sphénoïdal|sphénoïdale
sphénoïde|sphénoïde
sphérique|sphérique
sphéroïdal|sphéroïdale
spinal|spinale
spinosant|spinosante
spiral|spirale
spirituel|spirituelle
spiritueux|spiritueuse
splendide|splendide
spongieux|spongieuse
spontané|spontanée
sporadique|sporadique
sportif|sportive
spécial|spéciale
spécieux|spécieuse
spécifique|spécifique
spéculaire|spéculaire
spéculateur|spéculatrice
spéculatif|spéculative
stabilisateur|stabilisatrice
stable|stable
stagiaire|stagiaire
stagnant|stagnante
stalinien|stalinienne
statif|stative
stationnaire|stationnaire
statique|statique
statutaire|statutaire
statégique|statégique
stellaire|stellaire
sterling|sterling
stimulant|stimulante
stochastique|stochastique
stockable|stockable
stomacal|stomacale
stomachique|stomachique
stoïque|stoïque
strasbourgeois|strasbourgeoise
stratégique|stratégique
strict|stricte
strident|stridente
structural|structurale
structurel|structurelle
studieux|studieuse
stupide|stupide
stupéfait|stupéfaite
stupéfiant|stupéfiante
stéphanois|stéphanoise
stérile|stérile
stérilisant|stérilisante
stéréoscopique|stéréoscopique
suave|suave
subaigu|subaiguë
subalpin|subalpine
subalterne|subalterne
subaquatique|subaquatique
subconscient|subconsciente
subit|subite
subjectif|subjective
sublime|sublime
sublingual|sublinguale
submicronique|submicronique
subordonné|subordonnée
subreptice|subreptice
subrégional|subrégionale
subsaharien|subsaharienne
subsidiaire|subsidiaire
subsistant|subsistante
subsonique|subsonique
substantiel|substantielle
subséquent|subséquente
subtil|subtile
subtropical|subtropicale
suburbain|suburbaine
subversif|subversive
subéreux|subéreuse
successif|successive
successoral|successorale
succinct|succincte
succulent|succulente
sucrier|sucrière
sudoral|sudorale
suffisant|suffisante
suffixal|suffixale
suffocant|suffocante
suicidaire|suicidaire
suiffeux|suiffeuse
suintant|suintante
suisse|suisse
suivant|suivante
suiviste|suiviste
sujet|sujette
sulfureux|sulfureuse
sulfurique|sulfurique
sunnite|sunnite
superbe|superbe
superficiel|superficielle
superfin|superfine
superflu|superflue
superfétatoire|superfétatoire
superpuissant|superpuissante
supersonique|supersonique
superstitieux|superstitieuse
supplémentaire|supplémentaire
supplémenté|supplémentée
supplétif|supplétive
supportable|supportable
supposé|supposée
supranational|supranationale
suprême|suprême
supérieur|supérieure
sur|sure
suraigu|suraiguë
sural|surale
suranné|surannée
surarmé|surarmée
surdiplômé|surdiplômée
surdoué|surdouée
surfacturé|surfacturée
surfin|surfine
surhumain|surhumaine
surinamien|surinamienne
surmultiplié|surmultipliée
surnaturel|surnaturelle
surnuméraire|surnuméraire
surpeuplé|surpeuplée
surprenant|surprenante
surqualifié|surqualifiée
surréaliste|surréaliste
surréel|surréelle
survivant|survivante
suréminent|suréminente
susceptible|susceptible
susdit|susdite
susmentionné|susmentionnée
susnommé|susnommée
suspect|suspecte
suspensif|suspensives
susvisé|susvisée
sutural|suturale
suédois|suédoise
svelte|svelte
swappé|swappée
sybarite|sybarite
sylvestre|sylvestre
sylvicole|sylvicole
symbolique|symbolique
sympa|sympa
sympathique|sympathique
symphonique|symphonique
symptomatique|symptomatique
symétrique|symétrique
synchrone|synchrone
syndical|syndicale
syndicaliste|syndicaliste
synodal|synodale
synonyme|synonyme
synovial|synoviale
synthétique|synthétique
syphilitique|syphilitique
syrien|syrienne
systématique|systématique
systémique|systémique
sébacé|sébacée
sécable|sécable
sécant|sécante
sécessionniste|sécessionniste
séculaire|séculaire
sécularisé|sécularisée
séculier|séculière
sécuriste|sécuriste
sédatif|sédative
sédentaire|sédentaire
sédimentaire|sédimentaire
séditieux|séditieuse
séduisant|séduisante
séfarade|séfarade
séguiniste|séguiniste
séismal|séismale
séismique|séismique
sélect|sélecte
sélectif|sélective
sélectif|sélectives
sémantique|sémantique
sémillant|sémillante
séminal|séminale
sénatorial|sénatoriale
sénescent|sénescente
sénestre|sénestre
sénile|sénile
sénégalais|sénégalaise
séparatiste|séparatiste
sépulcral|sépulcrale
séquentiel|séquentielle
séreux|séreuse
séricicole|séricicole
sériel|sérielle
sérieux|sérieuse
sérique|sérique
séropositif|séropositive
sévère|sévère
sûr|sûre
tabou|tabou
tabou|taboue
tabétique|tabétique
tacite|tacite
taciturne|taciturne
tactile|tactile
taiwanais|taiwanaise
talentueux|talentueuse
talmudique|talmudique
talé|talée
tamoul|tamoul
tangent|tangente
tangentiel|tangentielle
tangible|tangible
tango|tango
tapant|tapante
taquin|taquine
tarabiscoté|tarabiscotée
tardif|tardive
tarifaire|tarifaire
tartare|tartare
tartufe|tartufe
tartuffe|tartuffe
tatillon|tatillonne
taxable|taxable
taylorien|taylorienne
taïwanais|taïwanaise
tchadien|tchadienne
tchèque|tchèque
tchécoslovaque|tchécoslovaque
tchékiste|tchékiste
technique|technique
technocratique|technocratique
technologique|technologique
tectonique|tectonique
teint|teinte
tel|telle
tel|telle
tellurien|tellurienne
tellurique|tellurique
temporaire|temporaire
temporal|temporale
temporel|temporelle
temporisateur|temporisatrice
tempérant|tempérante
tempéré|tempérée
tenable|tenable
tenace|tenace
tenant|tenante
tendre|tendre
tentant|tentante
terminologique|terminologique
ternaire|ternaire
terne|terne
terrestre|terrestre
terreux|terreuse
terrible|terrible
terrifiant|terrifiante
territorial|territoriale
terroriste|terroriste
tertiaire|tertiaire
testimonial|testimoniale
textile|textile
textuel|textuelle
thatchérien|thatchérienne
thaïlandais|thaïlandaise
thermal|thermale
thermique|thermique
thermogène|thermogène
thermonucléaire|thermonucléaire
thermoplastique|thermoplastique
thermoélectrique|thermoélectrique
thoracique|thoracique
thymique|thymique
thyroïde|thyroïde
thématique|thématique
théologal|théologale
théologien|théologienne
théologique|théologique
théoricien|théoricienne
théorique|théorique
théâtral|théâtrale
tibial|tibiale
tibétain|tibétaine
tien|tienne
tien|tienne
tiers|tierce
timide|timide
timoré|timorée
tinctorial|tinctoriale
tiqueté|tiquetée
tissu|tissue
titanesque|titanesque
titubant|titubante
titulaire|titulaire
titularisé|titularisée
tiède|tiède
tocard|tocarde
tolérable|tolérable
tolérant|tolérante
tombal|tombale
tombant|tombante
tonal|tonale
tonique|tonique
tonitruant|tonitruante
topique|topique
toquard|toquarde
torpide|torpide
torrentiel|torrentielle
torrentueux|torrentueuse
torride|torride
tors|torse
tortueux|tortueuse
torve|torve
total|totale
totalitaire|totalitaire
touareg|touareg
touchant|touchante
touffu|touffue
toulousain|toulousaine
tourdille|tourdille
touristique|touristique
tournant|tournante
tournois|tournois
toxicologique|toxicologique
toxicomaniaque|toxicomaniaque
toxique|toxique
tracassier|tracassière
trachéal|trachéale
traditionaliste|traditionaliste
traditionnel|traditionnelle
tragique|tragique
tranchant|tranchante
tranquille|tranquille
transactionnel|transactionnelle
transalpin|transalpine
transatlantique|transatlantique
transcendant|transcendante
transcendantal|transcendantale
transcommunautaire|transcommunautaire
transeuropéen|transeuropéenne
transformable|transformable
transformateur|transformatrice
transformationnel|transformationnelle
transfrontalier|transfrontalière
transfrontière|transfrontière
transfusionnel|transfusionnelle
transférable|transférable
transitaire|transitaire
transitif|transitive
transitoire|transitoire
translucide|translucide
transmissible|transmissible
transnational|transnationale
transnucléaire|transnucléaire
transparent|transparente
transportable|transportable
transposable|transposable
transrégional|transrégionale
transsaharien|transsaharienne
transsonique|transsonique
transversal|transversale
trapu|trapue
trapézoïdal|trapézoïdale
traumatisant|traumatisante
travailleur|travailleuse
travailliste|travailliste
traînant|traînante
traînard|traînarde
traître|traîtresse
tremblant|tremblante
tremblotant|tremblotante
triangulaire|triangulaire
tribal|tribale
tributaire|tributaire
tricennal|tricennale
tricheur|tricheuse
tricolore|tricolore
triennal|triennale
trilatéral|trilatérale
trilingue|trilingue
trimestriel|trimestrielle
triomphal|triomphale
triomphant|triomphante
triparti|tripartie
tripartite|tripartite
triphasé|triphasée
triple|triple
trisannuel|trisannuelle
triste|triste
trisyllabe|trisyllabe
triumviral|triumvirale
trivalent|trivalente
trivial|triviale
trièdre|trièdre
trochaïque|trochaïque
trompeur|trompeuse
trompeux|trompeuse
tropical|tropicale
trotskiste|trotskiste
trotskyste|trotskyste
troublant|troublante
trouble|trouble
truculent|truculente
truffé|truffée
trébuchant|trébuchante
trépidant|trépidante
trésorier|trésorière
tsigane|tsigane
tuberculeux|tuberculeuse
tubulaire|tubulaire
tubéreux|tubéreuse
tudesque|tudesque
tumescent|tumescente
tumoral|tumorale
tumulaire|tumulaire
tumultueux|tumultueuse
tunisien|tunisienne
tunisois|tunisoise
turbulent|turbulente
turc|turque
turgescent|turgescente
turquoise|turquoise
tutélaire|tutélaire
typique|typique
typographique|typographique
typologique|typologique
tyrannique|tyrannique
tzigane|tzigane
télégraphique|télégraphique
téléphonique|téléphonique
télévisuel|télévisuelle
téméraire|téméraire
ténu|ténue
ténébreux|ténébreuse
térébrant|térébrante
tétanique|tétanique
tétanisé|tétanisée
tétraédrique|tétraédrique
têtu|têtue
ubuesque|ubuesque
ukrainien|ukrainienne
ultime|ultime
ultracourt|ultracourte
ultralibéral|ultralibérale
ultramoderne|ultramoderne
ultramontain|ultramontaine
ultrasensible|ultrasensible
ultraviolet|ultraviolette
ultérieur|ultérieure
unanime|unanime
unanimiste|unanimiste
unguéal|unguéale
uni|unie
unicellulaire|unicellulaire
unicolore|unicolore
unidirectionnel|unidirectionnelle
unifonds|unifonds
uniforme|uniforme
unilatéral|unilatérale
unilingue|unilingue
uniloculaire|uniloculaire
uninominal|uninominale
unioniste|unioniste
unipersonnel|unipersonnelle
unique|unique
unisexe|unisexe
unisexuel|unisexuelle
unisexué|unisexuée
unitaire|unitaire
univalve|univalve
universel|universelle
universitaire|universitaire
univoque|univoque
unième|unième
urbain|urbaine
urbanistique|urbanistique
urbanisé|urbanisée
urgent|urgente
urinaire|urinaire
urique|urique
urticant|urticante
uruguayen|uruguayenne
urétral|urétrale
urétéral|urétérale
usagé|usagée
usité|usitée
usuel|usuelle
usufructuaire|usufructuaire
usufruitier|usufruitière
usuraire|usuraire
usé|usée
utile|utile
utilisable|utilisable
utilitaire|utilitaire
utopique|utopique
utérin|utérine
uval|uvale
uxorilocal|uxorilocale
vacant|vacante
vacataire|vacataire
vaccinal|vaccinale
vachard|vacharde
vagabond|vagabonde
vaginal|vaginale
vague|vague
vaillant|vaillante
vain|vaine
vainqueur|vainqueur
valable|valable
valeureux|valeureuse
valga|valga
valide|valide
vallonné|vallonnée
valoisien|valoisienne
valorisant|valorisante
valétudinaire|valétudinaire
vaniteux|vaniteuse
vantard|vantarde
vaporeux|vaporeuse
vara|vara
variable|variable
variqueux|variqueuse
varié|variée
variétal|variétale
vasculaire|vasculaire
vasoconstricteur|vasoconstrictrice
vasodilatateur|vasodilatatrice
vasomoteur|vasomotrice
vaste|vaste
vaticane|vaticane
vaudois|vaudoise
vaudou|vaudou
vectoriel|vectorielle
veinard|veinarde
velléitaire|velléitaire
velu|velue
vendable|vendable
vengeur|vengeresse
venimeux|venimeuse
venteux|venteuse
ventral|ventrale
ventripotent|ventripotente
ventru|ventrue
verbal|verbale
verbeux|verbeuse
verdâtre|verdâtre
vergeté|vergetée
vergé|vergée
verjuté|verjutée
vermeil|vermeille
vermicide|vermicide
vermiculaire|vermiculaire
vermifuge|vermifuge
vermillon|vermillon
vermoulu|vermoulue
vernaculaire|vernaculaire
vernal|vernale
verruqueux|verruqueuse
versaillais|versaillaise
versatile|versatile
versé|versée
vert|verte
vertical|verticale
vertigineux|vertigineuse
vertueux|vertueuse
vertébral|vertébrale
vespéral|vespérale
vestimentaire|vestimentaire
veule|veule
vexatoire|vexatoire
viable|viable
viager|viagère
vibrant|vibrante
vicennal|vicennale
vichyssois|vichyssoise
vichyste|vichyste
vicieux|vicieuse
vicinal|vicinale
victorien|victorienne
victorieux|victorieuse
vicésimal|vicésimale
vide|vide
vidéo|vidéo
vieillissant|vieillissante
vieillot|vieillotte
viennois|viennoise
vierge|vierge
vietnamien|vietnamienne
vieux|vieille
vif|vive
vigilant|vigilante
vigoureux|vigoureuse
vil|vile
vilain|vilaine
villageois|villageoise
villeux|villeuse
vindicatif|vindicative
vineux|vineuse
vinicole|vinicole
violacé|violacée
violent|violente
violet|violette
vipérin|vipérine
viral|virale
virevoltant|virevoltante
virginal|virginale
viril|virile
virilocal|virilocale
virtuel|virtuelle
virulent|virulente
viscéral|viscérale
visible|visible
visionnaire|visionnaire
visqueux|visqueuse
visuel|visuelle
vital|vitale
vitellin|vitelline
viticole|viticole
vitivinicole|vitivinicole
vitreux|vitreuse
vitré|vitrée
vivace|vivace
vivant|vivante
vivipare|vivipare
vocal|vocale
vociférant|vociférante
voisin|voisine
volant|volante
volatil|volatile
volcanique|volcanique
voleur|voleuse
volitif|volitive
volontaire|volontaire
volontariste|volontariste
volubile|volubile
volumineux|volumineuse
voluptueux|voluptueuse
vomique|vomique
vorace|vorace
votif|votive
voyageur|voyageuse
voyagiste|voyagiste
voyant|voyante
vrai|vraie
vraisemblable|vraisemblable
vulgaire|vulgaire
vulnérable|vulnérable
vulnéraire|vulnéraire
vultueux|vultueuse
védique|védique
végétal|végétale
véhiculaire|véhiculaire
véhément|véhémente
vélaire|vélaire
vélique|vélique
véloce|véloce
vénal|vénale
véniel|vénielle
vénitien|vénitienne
vénéneux|vénéneuse
vénérable|vénérable
vénérien|vénérienne
véreux|véreuse
véridique|véridique
vérifiable|vérifiable
véritable|véritable
vésical|vésicale
vésicant|vésicante
vésiculeux|vésiculeuse
vétillard|vétillarde
vétuste|vétuste
wallisien|wallisienne
xiphoïde|xiphoïde
xénophobe|xénophobe
yougoslave|yougoslave
yéménite|yéménite
zambien|zambienne
zazou|zazou
zaïrois|zaïroise
zimbabwéen|zimbabwéen
zinzin|zinzin
zodiacal|zodiacale
zonal|zonale
zoologique|zoologique
zoonotique|zoonotique
zoophilique|zoophilique
zootechnicien|zootechnicienne
zootechnique|zootechnique
zoulou|zouloue
zélé|zélée
zénithal|zénithale
âcre|âcre
âgé|âgée
âpre|âpre
ébaudi|ébaudie
éberlué|éberluée
éblouissant|éblouissante
éburnéen|éburnéenne
écailleux|écailleuse
écarlate|écarlate
écervelé|écervelée
échevinal|échevinale
échéant|échéante
éclatant|éclatante
éclectique|éclectique
éclopé|éclopée
écoeurant|écoeurante
écologique|écologique
écologiste|écologiste
économe|économe
économique|économique
écossais|écossaise
écrasant|écrasante
écru|écrue
éculé|éculée
édenté|édentée
édifiant|édifiante
éditeur|éditrice
éditorial|éditoriale
éducatif|éducative
édulcorant|édulcorante
égal|égale
égalitaire|égalitaire
égalitariste|égalitariste
égoïste|égoïste
égrillard|égrillarde
égyptien|égyptienne
éhonté|éhontée
élastique|élastique
électif|élective
électoral|électorale
électoraliste|électoraliste
électrique|électrique
électroacoustique|électroacoustique
électrogène|électrogène
électromagnétique|électromagnétique
électronique|électronique
électronucléaire|électronucléaire
élevé|élevée
éligible|éligible
éliminatoire|éliminatoire
élisabéthain|élisabéthaine
élitiste|élitiste
éloquent|éloquente
élyséen|élyséenne
élégant|élégante
élémentaire|élémentaire
émacié|émaciée
émeraude|émeraude
émergent|émergente
émetteur|émettrice
éminent|éminente
émissif|émissives
émollient|émolliente
émotif|émotive
émotionnel|émotionnelle
émoulu|émoulue
émouvant|émouvante
éméché|éméchée
émérite|émérite
émétique|émétique
énergique|énergique
énergétique|énergétique
énergétivore|énergétivore
énervant|énervante
énigmatique|énigmatique
énième|énième
énorme|énorme
éolien|éolienne
épais|épaisse
épars|éparse
épatant|épatante
épenthétique|épenthétique
éperdu|éperdue
éphémère|éphémère
épicentral|épicentrale
épicurien|épicurienne
épicène|épicène
épidermique|épidermique
épidémiologique|épidémiologique
épidémique|épidémique
épileptique|épileptique
épineux|épineuse
épique|épique
épiscopal|épiscopale
épiscopalien|épiscopalienne
épisodique|épisodique
épistolaire|épistolaire
épistémologique|épistémologique
épistémologue|épistémologue
éploré|éplorée
éponyme|éponyme
époustouflant|époustouflante
épouvantable|épouvantable
éprouvant|éprouvante
épuisant|épuisante
équatorial|équatoriale
équatorien|équatorienne
équestre|équestre
équiangle|équiangle
équidistant|équidistante
équilatéral|équilatérale
équin|équine
équinoxial|équinoxiale
équipementier|équipementière
équipollent|équipollente
équitable|équitable
équivalent|équivalente
équivoque|équivoque
érotique|érotique
érotomane|érotomane
érudit|érudite
érugineux|érugineuse
érythréen|érythréenne
ésotérique|ésotérique
étale|étale
étanche|étanche
étatique|étatique
éteint|éteinte
éternel|éternelle
éthiopien|éthiopienne
éthique|éthique
éthylique|éthylique
étincelant|étincelante
étonnant|étonnante
étonné|étonnée
étouffant|étouffante
étourdi|étourdie
étourdissant|étourdissante
étrange|étrange
étranger|étranger
étranger|étrangère
étriqué|étriquée
étroit|étroite
étrusque|étrusque
évaluable|évaluable
évanescent|évanescente
évangélique|évangélique
évangéliste|évangéliste
évasif|évasive
éveillé|éveillée
éventuel|éventuelle
évident|évidente
évitable|évitable
évocateur|évocatrice
évolutif|évolutive
événementiel|événementielle